0 0 0 0 0 0 0 0 0 0 0 0 0 0 0 3 0 0 0 0 0 0 0 0 4 0 0 0 0 0 0 0 0 0 0 0 3 0 0 0 0 0 0 0 0 0 0 0 0 0
0 0 0 0 0 0 0 0 0 3 0 0 0 0 0 0 0 0 0 0 0 0 3 0 0 0 0 0 0 0 0 3 0 0 0 0 0 0 0 0 0 0 3 0 0 0 0 0 0 0
0 0 0 0 0 0 0 0 0 0 0 0 0 0 0 0 0 0 0 0 0 0 0 0 0 0 0 4 0 0 0 0 0 0 0 0 0 0 0 0 0 0 3 3 0 0 0 0 0 4
0 0 0 0 0 0 0 0 0 0 0 0 0 0 0 0 3 0 0 0 0 0 0 0 0 0 0 0 0 0 3 4 0 0 0 0 3 0 0 0 0 0 0 0 0 0 0 0 0 0
0 0 0 0 0 3 0 0 0 0 0 0 0 4 0 0 0 0 0 0 3 0 0 3 0 0 0 0 0 0 0 0 3 0 0 0 0 0 0 0 0 0 0 0 0 0 0 0 0 0
0 0 0 0 0 0 0 0 2 0 2 2 4 2 2 0 2 2 2 0 0 2 0 2 2 2 0 0 0 2 2 0 2 0 0 0 0 0 2 2 2 0 2 0 0 0 2 2 2 2
0 0 0 0 0 0 0 0 0 2 2 2 2 0 0 2 2 2 0 2 2 3 0 0 2 2 2 0 0 0 0 2 2 0 2 2 0 0 0 0 0 2 2 0 2 2 3 3 2 0
4 0 3 3 0 0 0 0 2 0 2 2 0 2 0 2 2 2 0 2 0 0 2 2 2 2 2 0 2 2 0 2 2 2 2 0 2 2 2 2 0 0 2 0 3 0 4 2 0 2
0 0 0 0 0 0 0 0 2 2 8 2 8 8 2 2 2 0 2 0 2 2 0 0 2 0 2 0 2 2 2 0 0 0 2 2 2 2 2 2 0 2 0 2 2 0 0 2 2 0
0 0 0 0 0 0 0 0 2 2 8 2 2 2 2 2 2 2 0 2 2 2 2 2 2 2 2 0 2 0 2 0 2 2 2 2 0 0 2 2 2 0 2 2 2 2 2 2 0 2
0 0 3 0 0 0 0 0 0 2 2 2 2 2 2 0 0 2 2 0 2 2 2 2 2 0 0 0 2 0 0 2 0 0 0 2 2 2 2 2 0 0 2 0 0 0 0 2 3 0
0 0 0 0 0 0 0 0 4 8 2 8 8 2 0 2 0 0 2 2 0 0 0 2 2 2 2 3 0 2 0 2 2 2 2 0 2 4 2 2 2 0 2 2 2 2 2 2 0 0
0 0 0 3 0 0 0 0 2 0 2 2 0 2 2 0 0 0 2 2 2 2 0 2 2 2 2 2 2 2 0 2 0 3 0 0 2 0 2 2 3 2 0 0 2 2 2 0 2 0
0 0 0 0 0 0 0 0 0 0 0 2 0 4 2 0 2 0 0 2 2 0 2 0 2 2 2 2 0 0 0 0 2 2 0 0 0 0 2 2 2 2 0 0 0 2 2 2 0 0
0 0 0 0 0 0 0 0 2 2 2 0 0 0 2 2 0 0 0 2 2 2 2 2 2 0 0 2 2 2 0 2 0 2 0 0 0 2 2 0 0 2 0 0 2 0 2 0 2 2
0 0 0 0 0 0 0 0 0 0 0 2 2 2 2 2 2 2 0 0 2 0 2 2 0 2 2 2 0 0 2 0 0 0 0 2 2 2 2 2 2 0 0 2 2 2 0 0 2 0
0 0 0 4 0 3 0 0 4 2 0 2 0 0 0 2 2 2 2 2 0 2 2 2 2 0 2 2 2 2 2 2 2 2 0 2 2 2 2 0 2 2 2 2 2 0 0 0 2 0
0 0 0 0 6 0 0 0 2 2 2 2 2 2 2 0 2 2 2 2 0 0 2 2 0 2 0 0 2 2 2 0 0 2 2 0 0 2 0 0 2 2 2 2 2 2 2 2 0 2
0 0 4 0 6 6 0 0 0 2 2 2 2 2 2 2 0 0 2 0 2 2 0 0 0 0 0 2 2 2 2 2 2 2 2 2 2 2 0 2 2 2 2 2 2 2 2 2 2 0
4 3 0 0 6 6 6 0 0 0 0 0 3 0 0 2 2 0 0 2 2 2 2 2 3 2 2 2 0 2 2 2 2 2 2 2 2 2 2 4 2 0 2 2 3 0 2 0 2 2
0 0 0 0 0 0 6 6 0 2 0 2 0 2 0 2 2 2 0 0 0 0 2 2 2 2 2 2 2 0 2 2 0 2 2 2 2 0 2 2 2 0 0 0 2 2 2 2 0 0
0 0 0 0 0 0 6 6 0 0 0 2 2 2 2 2 2 0 0 2 2 2 2 2 2 2 0 0 2 0 2 0 0 0 2 2 0 2 2 2 0 0 2 0 2 2 0 0 0 0
0 0 0 0 4 0 0 0 2 0 0 2 2 0 0 0 0 2 0 4 2 2 2 2 0 2 2 2 3 0 0 2 0 2 0 0 2 2 2 2 2 0 2 0 0 2 2 0 0 2
0 0 0 0 0 0 0 0 0 2 0 0 0 2 2 2 0 2 0 2 2 2 2 2 0 0 2 2 0 2 0 2 2 2 2 2 0 2 2 0 0 2 0 0 2 2 2 0 2 2
3 0 0 0 0 0 0 0 2 0 2 2 2 2 2 2 2 2 2 0 2 0 2 2 2 2 0 0 0 2 2 0 2 2 2 0 3 2 2 2 2 0 0 0 2 2 2 0 2 2
0 0 0 0 0 0 0 0 2 2 2 2 2 0 0 2 0 0 2 0 0 3 0 0 2 0 2 0 2 2 2 2 2 2 0 2 2 2 0 0 2 2 2 2 0 2 2 0 2 4
0 0 0 0 0 0 0 3 2 2 2 0 0 0 2 2 2 2 0 2 2 2 2 2 2 2 2 2 2 0 0 0 2 2 3 2 2 4 2 0 2 0 0 2 0 2 2 2 2 2
0 0 0 0 0 0 0 0 0 0 2 2 4 2 2 2 2 0 2 4 2 2 2 2 2 2 0 2 2 2 2 2 2 2 0 2 2 2 0 2 2 2 2 0 0 2 0 4 0 0
0 0 0 0 0 0 0 0 0 3 3 2 0 2 2 2 0 2 2 0 2 0 4 0 2 4 0 0 0 2 2 2 2 2 0 2 0 2 2 0 2 2 3 0 0 2 2 2 2 2
0 4 0 0 0 0 0 3 0 2 2 2 2 0 2 2 2 2 2 0 2 0 2 2 0 2 0 0 2 0 2 0 2 0 2 0 2 2 2 0 2 2 2 2 2 2 0 2 2 0
0 0 0 0 0 0 0 0 2 3 2 2 2 0 3 2 2 2 0 2 2 2 2 2 0 2 4 0 2 0 2 2 0 2 0 0 2 0 2 2 2 0 2 3 2 0 2 2 2 0
0 0 0 3 0 0 0 0 0 2 2 0 2 2 3 0 0 2 2 2 0 2 0 2 0 2 2 0 0 2 2 0 0 2 2 2 0 2 2 0 0 0 2 2 2 0 2 2 3 0
4 0 0 0 0 4 0 0 2 2 0 2 2 2 0 2 2 2 0 2 0 0 0 0 0 0 2 2 0 0 2 2 2 0 0 2 2 2 2 0 0 2 2 0 0 0 0 0 0 2
0 0 0 0 0 0 0 0 2 0 2 2 0 0 2 0 0 2 3 2 0 0 4 0 2 2 0 2 0 2 0 2 2 2 0 2 2 2 2 2 0 2 0 2 0 2 2 2 2 2
0 3 0 0 0 0 0 0 0 2 2 0 2 0 0 0 2 2 0 3 0 2 2 0 0 0 2 2 0 2 2 2 2 2 2 2 2 2 0 0 2 0 2 2 2 0 4 0 0 4
0 0 0 0 0 0 0 0 2 0 2 0 2 4 2 2 0 2 2 2 2 2 2 0 2 2 2 2 0 0 2 4 2 2 2 2 2 2 2 2 2 0 2 2 0 2 0 0 0 2
0 0 0 0 0 0 0 0 0 4 2 0 0 0 2 0 4 0 2 0 2 2 2 0 0 2 2 2 2 0 2 2 2 2 2 2 2 2 2 0 0 0 2 2 2 0 4 0 2 2
0 0 3 0 0 0 3 4 3 0 0 0 3 3 0 0 0 0 0 0 0 0 0 0 0 0 0 0 0 0 0 0 0 0 0 0 0 0 0 0 0 0 0 0 0 0 0 0 0 0
0 0 0 0 0 0 0 0 0 0 3 0 4 0 0 0 0 0 0 0 0 0 3 0 0 0 0 0 0 0 0 0 0 0 0 0 0 0 3 0 0 0 0 0 0 0 0 0 0 0
0 0 0 0 0 0 4 0 0 3 0 0 0 0 3 4 0 0 3 3 0 0 3 0 0 0 0 0 0 0 3 0 0 0 0 4 3 0 0 3 0 0 0 0 0 0 4 0 0 3
0 4 0 0 0 0 0 0 0 0 0 0 0 0 3 0 0 0 3 4 0 0 0 0 0 0 0 0 0 0 0 0 0 0 4 0 0 0 4 0 0 0 0 0 0 0 0 0 0 0
0 0 0 0 0 0 0 0 0 0 0 0 3 0 3 0 0 0 0 0 0 0 0 0 0 4 0 4 0 0 3 0 0 0 0 0 0 0 0 0 0 0 0 0 0 0 0 0 0 0
0 0 0 0 0 0 0 0 0 0 0 3 0 0 0 0 0 0 0 0 0 0 0 0 0 0 3 0 0 0 0 4 3 4 0 0 0 0 0 0 0 0 0 0 0 0 0 0 0 4
3 0 0 0 0 0 0 4 0 0 0 0 0 3 0 0 0 0 0 0 0 0 3 0 0 0 0 3 4 0 0 0 0 0 0 0 0 0 0 0 0 0 0 0 0 0 0 0 0 0
3 0 0 0 0 0 0 0 0 0 0 0 0 0 0 0 0 0 0 0 0 0 0 0 4 0 0 0 0 0 0 0 0 4 4 0 0 0 0 0 0 0 0 0 0 0 4 0 0 4
0 0 0 0 0 0 0 0 0 0 0 0 0 0 0 0 0 0 0 0 0 0 0 0 0 0 0 0 0 0 0 4 0 0 0 0 0 0 0 0 0 0 0 0 4 3 0 0 3 0
0 0 0 0 0 0 0 0 3 0 0 0 0 0 0 0 0 0 0 4 0 0 0 0 0 0 0 0 0 3 0 0 0 0 0 3 0 0 0 0 0 0 0 0 0 0 0 0 0 0
0 0 0 3 4 0 0 0 0 0 0 0 0 0 0 3 0 0 0 0 0 0 0 0 0 0 0 3 4 0 0 4 0 0 0 0 0 0 0 0 0 0 0 0 4 0 3 0 0 0
0 4 0 0 0 0 0 0 0 0 0 0 3 0 0 0 0 0 0 0 0 0 0 0 4 0 0 0 0 0 0 0 0 0 0 0 0 0 0 0 0 0 0 0 0 0 0 0 0 0
0 0 0 0 0 0 4 4 0 0 0 0 0 0 0 0 0 0 0 0 0 0 0 0 0 0 0 3 0 0 0 0 0 0 0 0 0 4 0 0 0 0 0 0 0 0 0 0 0 0
