2 2 2 2 2 2 2 2 2 2 2 2 2 2 2 2 2 2 2 2 2 8 8 2 2 2 2 2 2 2 2 2 2 2 2 2 2 2 2 2 2 2 2 2 2 2 2 2 2 2 2 2 2 2 2 2 2 2 2 2 2 2 2 2 2 2 2 2 2 2 2 2 2 2 2 2 2 2 2 2 2 2 2 2 2 2 2 2 2 2 2 2 2 2 2 2 2 2 2 2
2 6 2 2 2 2 2 2 7 7 2 2 2 2 2 2 2 2 2 2 2 8 8 0 0 0 0 0 0 0 0 0 0 0 0 0 0 0 0 0 0 0 0 0 0 0 0 0 2 0 0 0 0 0 0 0 0 0 0 0 0 0 0 0 0 0 0 0 2 0 0 0 0 0 0 0 2 2 2 2 2 2 2 2 2 2 2 2 2 2 2 2 2 2 2 2 3 3 2 2
2 6 6 6 2 2 2 7 7 2 7 2 2 2 2 2 2 2 2 2 2 8 8 0 0 0 2 0 0 2 0 0 6 6 6 6 6 0 6 6 6 6 6 0 2 0 0 0 0 6 6 6 6 0 0 0 0 2 0 2 0 0 0 0 0 0 0 0 0 0 0 0 0 0 0 0 0 0 2 2 2 2 2 2 2 2 2 2 2 2 8 8 8 8 2 2 3 2 2 2
2 2 2 6 2 2 2 2 2 2 2 2 2 2 2 2 2 0 0 0 0 8 8 0 0 0 0 0 0 0 0 6 6 2 0 0 6 6 6 3 3 3 6 6 6 0 0 6 6 6 2 0 6 6 6 0 0 0 0 0 0 0 0 0 0 0 0 0 0 0 0 0 0 0 0 0 2 0 0 2 0 0 0 2 0 2 2 2 2 8 8 8 8 8 8 2 2 7 7 2
2 2 2 6 6 6 6 2 2 2 2 2 2 2 2 2 0 0 0 6 6 9 9 6 6 0 0 0 0 0 6 6 2 2 0 0 0 0 5 8 8 8 5 0 6 6 6 6 2 2 2 0 0 0 6 6 6 6 6 6 0 0 0 0 0 0 0 0 0 0 0 0 0 0 2 0 0 0 2 0 0 0 0 0 0 0 2 2 8 8 8 8 8 8 8 2 7 7 7 2
2 2 2 2 2 2 6 2 2 2 2 2 2 2 7 0 0 0 6 6 3 8 8 0 6 6 2 0 6 6 6 0 0 0 0 0 0 5 8 8 8 8 5 5 0 0 0 2 2 2 2 0 0 0 0 0 0 0 0 6 6 6 6 0 0 0 0 0 0 0 0 0 0 2 6 6 6 6 6 0 0 0 0 0 2 0 2 2 8 8 8 8 2 2 2 2 7 6 0 2
2 2 2 2 2 2 6 2 2 2 2 2 0 0 2 0 7 6 6 0 0 8 8 2 0 6 6 6 6 0 0 0 0 0 0 0 0 8 8 8 8 5 5 0 0 0 0 2 2 3 3 0 0 0 0 0 0 0 0 0 0 0 6 6 6 6 6 6 0 0 0 0 6 6 6 0 0 0 6 6 6 6 6 2 0 2 2 8 8 8 2 2 2 2 7 0 0 6 0 2
2 2 2 2 2 2 6 6 2 2 2 2 0 0 0 2 0 6 0 0 0 8 8 0 0 0 0 0 0 0 0 0 2 0 0 0 0 8 8 8 0 0 0 0 0 0 0 0 0 0 3 0 0 0 0 0 0 0 0 2 0 0 0 0 0 0 0 6 6 6 6 6 6 0 0 0 0 0 2 0 0 0 6 6 6 0 0 0 8 8 3 2 2 2 7 0 0 6 0 2
2 2 2 2 2 2 2 6 6 6 0 2 2 0 2 0 0 6 0 0 0 8 8 0 0 0 0 0 0 0 0 0 0 0 0 0 6 8 0 0 0 2 0 0 0 0 0 0 0 2 0 0 0 0 0 0 0 0 0 2 0 0 0 0 0 0 0 0 0 6 0 0 0 0 0 0 0 0 0 0 0 0 0 0 6 6 6 6 3 9 9 8 2 2 2 0 6 6 0 2
2 2 2 2 2 2 2 2 2 6 6 0 0 0 0 0 0 6 0 2 8 8 8 0 0 0 0 0 0 0 0 0 0 6 6 6 6 0 0 0 0 0 0 0 0 0 0 0 0 0 0 0 0 0 0 0 0 0 0 0 0 0 0 2 0 2 2 0 0 6 6 0 0 0 0 0 0 0 0 0 0 0 0 2 0 0 2 0 2 0 9 9 9 3 6 6 6 0 0 2
2 2 5 2 2 2 2 2 2 0 6 6 6 6 6 6 6 6 6 9 8 8 0 0 0 0 2 0 0 0 0 6 6 6 0 0 0 0 0 0 0 0 0 0 0 0 0 0 0 0 0 0 0 0 0 0 0 2 0 0 0 0 0 0 0 0 0 0 0 0 6 0 0 0 0 0 0 0 0 0 0 0 0 0 0 0 0 0 0 0 8 8 8 8 2 0 6 0 0 2
2 2 2 2 2 2 2 2 2 2 6 3 0 0 0 0 0 0 8 9 9 0 0 0 0 0 0 6 6 6 6 6 0 0 0 0 0 0 0 0 0 0 0 0 0 0 0 0 0 0 0 0 0 2 0 0 0 0 0 0 0 0 0 0 0 0 0 0 2 0 6 6 0 0 0 0 2 0 0 0 0 0 0 0 0 2 0 0 0 8 8 8 8 8 2 2 6 6 0 2
2 2 2 2 2 2 2 0 6 6 6 0 0 0 0 4 0 8 8 8 6 6 0 0 0 0 0 6 0 0 0 0 0 0 0 0 0 0 0 0 0 0 0 0 0 0 0 0 0 0 0 0 0 0 0 0 0 4 0 4 0 0 0 0 2 2 0 2 0 0 0 6 0 0 0 0 0 0 0 0 0 0 0 2 0 0 0 0 8 8 8 8 8 8 8 2 2 6 0 2
2 2 2 2 2 0 2 6 6 2 2 3 0 0 4 0 8 8 8 3 3 6 6 0 0 0 6 6 0 0 0 0 0 0 0 0 0 0 0 0 0 0 0 0 0 0 0 0 0 2 0 0 0 0 0 0 0 0 0 0 0 0 2 0 0 0 0 0 0 2 0 6 0 0 0 2 0 0 0 2 0 0 0 0 0 0 0 8 8 8 8 9 8 8 8 8 2 6 6 2
2 2 2 2 0 2 2 6 2 2 2 3 3 2 0 8 8 8 0 3 3 3 6 6 6 6 6 0 0 0 0 0 0 0 0 0 0 0 0 0 0 0 0 0 0 0 0 0 0 2 0 0 0 2 0 0 0 0 0 0 0 0 2 0 0 0 0 0 0 0 0 6 0 0 0 0 0 0 0 0 0 0 0 2 0 0 2 8 8 8 8 8 8 8 2 2 2 2 6 2
2 0 2 0 0 0 6 6 0 2 2 2 3 0 8 8 8 8 8 3 3 0 6 0 0 0 0 0 0 0 0 0 0 0 0 0 0 0 0 0 0 0 0 0 0 0 0 0 0 0 0 0 0 0 0 0 0 0 0 2 0 4 0 0 0 0 0 0 2 0 6 6 0 0 2 0 0 0 0 0 0 0 0 0 3 2 0 2 8 8 8 8 8 9 2 2 2 3 6 2
2 0 0 0 2 0 6 0 0 0 0 0 8 8 8 8 8 8 8 3 0 6 6 0 0 0 0 0 0 0 0 0 0 0 0 0 0 0 0 0 0 0 0 0 0 0 0 0 0 2 0 0 0 0 0 0 0 0 0 0 4 4 4 0 0 0 0 0 0 0 6 3 2 0 2 0 0 0 0 0 0 0 0 0 0 0 0 2 2 8 8 8 8 2 2 3 6 6 6 2
2 0 0 0 0 6 6 0 0 8 8 8 8 8 3 3 8 8 8 0 0 6 0 0 0 0 0 0 2 2 0 0 0 0 0 0 0 0 0 0 0 0 0 0 0 0 0 0 0 0 0 0 0 0 2 0 0 0 0 0 4 0 0 0 0 0 0 0 2 3 6 0 0 2 0 0 0 2 0 0 0 0 2 0 0 0 3 0 7 2 2 8 2 2 0 3 6 0 0 2
2 0 0 2 0 6 0 0 8 8 8 8 8 0 0 3 8 8 8 6 6 6 0 0 0 0 0 0 0 0 0 0 2 2 0 0 0 0 0 0 0 0 0 0 0 0 0 0 0 0 0 0 0 0 0 0 0 0 0 0 0 0 0 0 0 0 0 0 0 6 6 0 0 0 2 0 0 0 0 0 0 0 0 0 0 0 0 7 7 7 2 2 2 6 6 6 6 0 0 2
2 0 0 0 0 6 0 8 8 0 0 0 0 0 0 0 8 8 8 0 0 0 0 4 0 0 0 0 0 0 0 0 0 0 0 0 2 2 0 0 0 0 0 0 0 2 0 0 0 0 2 2 2 0 0 0 0 0 0 0 0 0 0 0 0 0 0 6 6 6 0 0 0 0 0 0 0 0 0 0 0 0 0 0 0 0 0 7 0 0 0 0 6 6 0 0 0 0 0 2
8 8 8 8 8 9 8 8 0 0 0 0 0 0 0 0 8 8 8 0 0 0 4 0 4 0 2 2 0 0 0 0 0 0 0 0 0 0 0 0 0 0 0 0 0 0 0 0 0 0 2 0 0 0 0 0 0 3 0 0 0 0 0 2 0 0 0 6 3 2 0 0 2 2 0 0 0 0 0 0 0 0 0 0 0 0 0 0 0 0 0 0 6 0 0 0 0 0 0 2
8 8 8 8 8 9 8 0 0 0 0 0 0 0 0 0 8 8 8 0 0 0 0 4 0 0 0 0 0 0 0 0 0 0 0 0 2 0 2 0 0 0 0 0 2 0 0 0 0 0 0 0 0 0 0 0 3 0 0 0 0 7 2 2 0 0 0 6 0 0 0 2 2 2 2 0 0 0 0 0 0 0 0 0 0 0 0 0 0 0 2 6 6 0 0 0 0 0 0 2
2 0 0 0 0 0 0 0 0 0 0 0 0 2 0 8 8 8 8 0 0 0 0 0 0 0 0 0 0 0 2 2 0 0 0 0 0 0 0 0 0 0 0 0 0 0 0 0 0 0 0 0 0 0 0 0 0 3 0 0 7 2 2 2 2 2 0 6 3 2 2 2 2 2 2 2 0 0 2 0 0 0 2 0 0 0 0 0 0 0 0 6 0 2 0 0 0 0 0 2
2 0 0 0 0 0 0 0 0 0 0 0 0 0 8 8 8 8 8 0 0 0 0 0 0 2 2 0 0 0 0 0 0 2 0 0 0 0 0 0 0 0 0 0 0 0 0 0 0 0 0 0 2 0 0 0 0 0 0 3 2 2 2 2 2 2 2 6 2 2 2 2 2 2 2 2 2 0 0 0 0 0 0 0 0 0 0 0 0 0 6 6 0 0 0 0 0 2 0 2
2 0 0 0 0 0 0 0 0 0 0 0 0 8 8 0 8 8 8 0 0 0 0 0 0 0 0 0 0 0 0 0 0 2 0 0 0 0 0 0 0 0 0 0 0 0 0 0 0 0 0 0 0 0 0 0 0 0 3 2 2 2 2 2 2 2 6 6 2 2 2 2 2 2 2 0 0 0 0 0 0 0 0 0 0 0 0 2 0 6 6 0 2 0 3 2 0 0 0 2
2 0 0 0 0 0 0 0 0 0 0 0 8 8 0 0 8 8 8 0 0 0 0 2 0 0 0 0 0 0 0 0 2 0 0 0 3 0 0 0 2 0 0 3 0 0 0 0 0 3 0 3 0 0 0 0 3 2 2 2 2 2 2 2 2 2 6 2 2 2 2 2 2 2 0 0 0 0 0 0 0 0 0 0 0 0 0 0 0 6 0 0 0 2 0 0 0 0 0 2
2 0 3 3 0 0 0 0 0 0 0 8 8 0 0 0 8 8 8 0 0 0 0 0 0 0 0 0 0 0 0 0 0 0 0 0 0 0 0 0 0 2 0 0 0 0 0 0 0 3 0 0 0 0 0 0 0 0 2 2 2 2 2 2 2 2 6 2 2 2 2 2 2 0 0 0 0 0 0 0 0 0 0 0 0 0 2 0 6 6 0 0 3 3 3 0 0 0 0 2
2 0 0 3 0 3 0 0 0 0 8 8 0 2 0 0 8 8 8 0 0 0 0 0 0 0 0 2 0 0 0 0 2 0 0 0 3 0 0 3 0 0 3 0 3 0 0 0 0 0 2 0 0 0 0 0 0 0 7 2 2 2 2 2 2 2 6 2 2 2 2 2 2 0 0 0 0 0 0 0 0 0 0 2 2 0 0 6 6 0 0 0 0 0 3 0 0 0 0 2
2 0 0 0 0 3 0 0 3 0 8 8 0 0 0 2 8 8 8 0 0 2 0 3 0 0 0 0 3 3 0 0 0 2 2 0 3 0 0 0 0 0 0 0 0 0 0 0 0 0 0 0 0 0 0 0 0 0 0 0 2 2 2 2 2 2 6 2 2 2 2 2 0 3 0 0 3 0 0 0 0 0 0 0 0 0 0 6 0 0 0 2 0 0 0 0 0 0 0 2
2 2 0 0 0 0 0 0 0 0 8 8 0 0 0 2 8 8 8 0 0 0 0 0 0 3 0 0 0 0 0 2 0 0 0 0 3 0 0 0 0 0 0 0 0 0 0 0 0 2 0 0 0 0 0 0 0 0 7 0 0 2 2 2 2 2 6 2 2 2 2 0 0 0 3 0 0 0 0 0 0 0 0 0 0 0 6 6 0 0 0 2 2 3 0 0 0 0 0 2
2 0 0 0 0 0 0 0 0 0 8 8 0 0 0 0 0 0 0 0 0 0 0 0 2 0 0 0 0 0 0 0 0 0 0 2 0 0 0 2 3 0 0 0 0 0 0 0 0 0 0 0 3 0 0 0 0 0 0 0 3 3 3 2 2 6 6 2 0 0 3 0 2 0 0 0 0 0 0 0 0 0 2 3 0 6 6 0 0 0 0 0 0 2 0 0 0 0 0 2
2 3 0 0 0 0 0 0 0 0 0 8 8 0 0 0 0 0 0 2 0 0 0 0 0 0 0 0 0 0 0 3 0 2 2 2 0 0 0 0 0 0 0 0 0 0 0 0 0 0 0 0 0 0 0 0 0 0 0 0 7 3 0 0 7 6 7 0 0 0 0 0 0 0 0 0 0 0 0 2 6 6 6 6 6 6 0 0 0 0 0 0 0 0 0 0 0 3 0 2
2 0 0 3 2 0 0 0 3 3 0 0 8 8 0 0 3 0 3 0 0 0 0 0 0 3 0 0 0 0 0 0 0 0 0 0 0 0 0 3 0 0 0 2 0 0 2 0 0 2 0 0 0 0 2 0 0 0 0 0 0 0 0 0 3 6 7 0 0 0 0 0 0 0 0 0 0 6 6 6 6 2 0 0 3 0 0 0 0 0 0 0 0 0 0 0 0 0 0 2
2 0 0 2 0 0 0 2 2 0 0 0 0 8 8 0 2 3 3 0 0 0 0 0 0 0 0 0 3 0 0 0 0 0 3 0 2 0 0 0 0 3 0 0 0 3 0 0 0 0 0 0 0 2 0 0 0 0 2 0 3 0 0 3 0 6 0 3 0 2 0 0 0 0 0 6 6 6 0 0 0 0 0 3 0 0 0 0 2 0 0 0 0 0 0 0 0 0 0 2
2 0 0 3 0 0 0 2 2 0 0 0 0 0 8 8 0 4 0 0 0 0 0 0 0 0 0 0 0 0 0 0 0 0 0 0 0 0 0 3 0 0 0 0 0 0 0 0 0 0 2 0 0 2 0 0 0 0 0 0 0 0 0 0 6 6 0 0 0 0 0 6 6 6 6 6 0 0 0 0 0 0 0 0 0 0 2 0 0 0 0 0 0 0 0 0 0 0 0 2
2 0 0 0 0 0 0 0 0 0 0 0 3 0 0 8 8 8 8 8 0 0 0 0 0 0 0 0 0 0 0 0 0 0 0 0 0 0 0 0 3 0 0 0 0 2 2 2 2 2 0 2 2 2 2 2 0 0 0 0 0 0 3 0 6 0 0 6 6 6 6 6 0 0 0 0 0 0 0 0 0 0 0 2 3 0 0 0 0 0 0 0 0 3 0 0 0 3 0 2
2 0 2 2 0 0 0 0 0 0 0 0 0 0 0 4 8 8 8 8 0 0 0 0 0 0 0 0 0 0 0 0 0 0 0 0 0 0 0 0 0 0 0 2 2 0 0 0 0 0 0 0 0 0 0 0 2 2 0 0 0 0 0 0 6 6 6 6 0 0 0 3 0 0 2 0 0 0 0 0 3 0 0 0 0 0 0 3 0 0 0 0 0 3 0 0 0 3 0 2
2 0 3 0 0 0 0 0 0 0 0 0 0 0 0 0 0 0 3 0 0 0 0 2 0 0 0 0 2 0 0 0 0 0 0 0 0 0 0 0 2 2 2 0 0 0 0 0 0 0 0 0 0 0 0 0 0 0 2 2 0 0 0 6 6 0 0 0 0 0 0 0 0 0 0 2 3 0 0 0 3 3 0 0 0 0 0 0 0 0 0 0 0 0 0 0 0 2 0 2
2 0 0 0 3 0 0 0 0 0 0 0 0 0 0 0 0 0 3 0 0 0 0 0 0 0 0 2 0 0 0 0 0 0 0 0 0 0 0 0 2 0 0 0 0 0 0 0 0 0 0 0 0 0 0 0 0 0 0 0 2 0 0 6 0 0 0 0 0 0 2 0 0 0 0 0 0 0 0 0 0 0 0 0 0 0 2 0 0 0 0 0 0 0 0 0 0 0 0 2
2 0 0 0 0 0 2 0 0 0 0 0 3 0 0 0 3 3 3 0 0 0 0 0 3 0 0 0 0 0 3 2 0 0 0 0 0 0 0 2 0 0 0 0 0 0 0 0 0 0 0 0 0 0 0 0 0 0 0 0 0 2 0 6 0 0 2 0 0 0 0 0 0 0 3 0 0 0 0 0 0 0 0 3 0 0 0 0 0 0 2 0 0 0 0 3 2 0 0 2
2 0 0 0 0 0 2 0 0 3 0 3 0 0 0 2 0 0 0 0 0 0 0 0 4 0 0 0 0 3 0 2 0 3 0 0 0 0 2 0 0 0 0 0 0 0 0 0 0 0 0 0 0 0 0 0 0 0 0 0 0 0 2 6 6 0 0 0 0 0 0 0 2 0 0 2 0 0 0 0 0 0 0 0 0 0 0 2 0 0 0 3 0 0 0 2 0 2 0 2
2 0 0 0 0 0 2 2 0 2 0 3 2 0 0 0 0 0 0 0 0 0 0 0 0 4 0 0 0 0 0 0 0 0 2 0 0 2 0 0 0 0 0 0 0 0 0 0 0 0 0 0 0 0 0 0 0 0 0 0 0 0 0 2 6 6 0 0 0 0 0 3 3 0 2 0 0 2 0 0 2 0 0 0 0 0 3 0 0 0 0 0 0 2 0 0 0 0 0 2
2 0 0 0 0 0 2 0 0 0 0 0 0 0 0 2 2 0 0 0 0 0 0 0 0 0 0 0 0 0 0 3 0 0 0 0 0 2 0 0 0 0 0 0 0 0 0 0 0 0 0 0 0 0 0 0 0 0 0 0 0 0 0 2 0 6 6 0 0 0 0 3 0 0 0 0 0 0 0 2 0 0 0 0 0 0 0 0 0 0 2 0 0 0 0 0 0 0 0 2
2 0 2 0 0 0 3 0 0 0 0 0 0 2 0 0 0 0 0 0 0 0 0 0 0 2 2 0 0 0 0 0 0 0 0 0 2 0 0 0 0 0 0 0 0 0 0 0 0 0 0 0 0 0 0 0 0 0 0 0 0 0 0 0 2 0 6 0 0 0 0 0 0 0 0 0 0 0 0 0 0 0 2 0 0 0 2 0 2 0 0 2 0 0 0 0 0 2 0 2
2 0 2 0 0 0 0 0 0 0 2 0 0 3 0 0 0 0 0 0 0 0 0 0 0 0 0 0 0 0 0 0 0 0 0 0 2 0 0 0 0 0 0 0 0 0 0 0 0 0 0 0 0 0 0 0 0 0 0 0 0 0 0 0 2 0 6 6 6 0 0 0 0 0 0 0 0 0 0 0 0 0 0 2 0 0 0 0 0 0 2 0 0 0 0 3 0 0 0 2
2 0 0 0 3 0 0 0 0 0 0 0 0 0 0 0 0 0 0 0 0 0 0 0 0 0 0 0 0 2 0 0 0 0 0 2 0 0 0 0 0 0 0 0 0 0 0 0 0 0 0 0 0 0 0 0 0 0 0 0 0 0 0 0 0 2 3 0 6 0 0 0 0 0 0 0 0 0 0 0 0 0 0 0 0 0 3 3 3 0 0 0 0 0 0 0 0 0 0 2
2 0 0 0 0 0 0 0 0 0 0 0 0 0 0 2 0 0 0 2 0 0 0 0 0 0 0 0 0 0 0 0 0 0 2 2 0 0 0 0 0 0 0 0 0 0 0 0 0 0 0 0 0 0 0 0 0 0 0 0 0 0 0 0 0 2 0 0 6 0 0 0 0 0 0 0 0 0 0 0 0 0 0 3 0 0 2 3 2 0 0 0 2 0 0 0 0 2 0 2
2 0 0 0 0 3 0 0 0 0 0 2 0 0 0 0 3 2 0 0 2 0 0 0 0 0 0 0 3 0 0 0 0 0 0 2 0 0 0 0 0 0 0 0 0 0 0 0 0 0 0 0 0 0 0 0 0 0 0 0 0 0 0 0 0 2 0 0 6 6 2 0 0 0 0 0 0 0 2 2 0 0 0 0 0 0 2 0 3 0 0 0 0 3 0 2 2 0 0 2
2 0 0 0 0 0 0 0 0 0 0 0 0 0 0 0 0 0 0 0 0 0 0 0 0 0 0 0 0 0 0 0 0 3 0 2 0 0 0 0 0 0 0 0 0 0 0 0 0 0 0 0 0 0 0 0 0 0 0 0 0 0 0 0 0 2 2 0 0 6 6 6 2 0 0 2 0 0 0 3 0 2 0 0 0 0 4 0 2 3 0 0 0 0 0 0 0 0 0 2
2 0 2 0 0 0 0 3 0 0 0 0 0 0 0 0 0 0 0 0 0 0 0 0 0 0 0 0 0 0 0 0 0 0 0 2 0 0 0 0 0 0 0 0 0 0 0 0 0 0 0 0 0 0 0 0 0 0 0 0 0 0 0 0 0 2 3 3 0 0 0 6 6 0 0 0 0 0 0 0 3 0 0 0 0 0 0 0 0 0 0 0 0 3 0 0 0 0 0 2
2 0 0 0 0 4 0 4 0 0 0 0 0 0 0 0 0 0 0 0 0 0 0 0 0 0 0 0 0 0 0 0 0 0 0 0 0 0 0 0 0 0 0 0 0 0 0 0 0 0 0 0 0 0 0 0 0 0 0 0 0 0 0 0 0 0 3 0 0 0 0 0 6 6 0 0 0 0 0 4 4 0 0 0 0 0 0 4 0 4 0 0 0 0 0 0 0 0 0 2
2 0 0 0 0 0 0 0 0 0 0 0 0 0 0 0 0 0 0 0 0 0 0 0 0 0 0 0 0 0 0 0 4 0 0 2 0 0 0 0 0 0 0 0 0 0 0 0 0 0 0 0 0 0 0 0 0 0 0 0 0 0 0 0 0 2 0 0 0 0 4 0 0 6 0 0 0 5 0 0 0 0 4 0 0 0 0 5 0 0 0 0 0 0 0 0 4 0 0 2
2 0 0 0 4 0 0 5 0 3 0 0 0 0 0 0 0 0 0 0 0 0 0 0 0 2 0 0 0 0 0 0 0 0 0 2 0 0 0 0 0 0 0 0 0 0 0 0 0 0 0 0 0 0 0 0 0 0 0 0 0 0 0 0 0 2 0 0 0 0 0 0 0 6 0 0 0 0 0 0 0 0 0 0 0 0 5 4 0 4 0 0 0 0 0 0 0 0 0 2
2 0 0 0 0 0 0 0 0 0 0 0 0 0 0 0 0 5 0 0 0 4 4 0 0 5 4 0 0 0 0 0 0 0 0 2 0 0 0 0 0 0 0 0 0 0 0 0 0 0 0 0 0 0 0 0 0 0 0 0 0 0 0 0 0 2 0 0 0 0 0 0 0 6 6 6 0 0 0 0 0 0 5 0 3 0 5 0 0 0 0 0 0 0 0 0 0 0 0 2
2 0 0 0 0 0 0 0 0 0 0 0 0 0 0 0 0 0 0 0 0 0 0 5 0 0 2 0 4 4 0 0 0 0 0 2 0 0 0 0 0 0 0 0 0 0 0 0 0 0 0 0 0 0 0 0 0 0 0 0 0 0 0 0 0 2 0 0 0 0 0 0 0 0 0 6 0 4 0 0 0 0 0 0 4 0 0 0 5 0 0 0 0 0 0 0 4 0 0 2
2 0 0 0 0 0 5 0 0 0 0 0 0 0 0 0 0 0 0 0 0 0 0 0 0 0 0 5 4 5 0 5 0 0 0 2 0 0 0 0 0 0 0 0 0 0 0 0 0 0 0 0 0 0 0 0 0 0 0 0 0 0 0 0 0 2 0 0 0 0 0 0 0 0 0 6 6 4 0 3 0 0 0 0 0 5 0 0 0 4 0 0 0 0 5 0 0 0 0 2
2 0 4 0 0 0 0 0 0 0 5 4 0 0 0 0 0 0 0 0 0 0 5 5 0 0 0 4 0 0 0 0 0 0 0 0 2 0 0 0 0 0 0 0 0 0 0 0 0 0 0 0 0 0 0 0 0 0 0 0 0 0 0 0 2 0 0 0 0 5 0 0 0 0 0 0 6 6 0 0 3 3 0 0 0 0 0 0 0 0 0 0 0 0 0 0 0 0 0 2
2 0 0 0 0 0 0 0 0 0 0 0 0 0 0 5 0 5 0 0 5 0 0 0 0 0 0 0 0 4 0 0 0 0 0 0 2 0 0 0 0 0 0 0 0 0 0 0 0 0 0 0 0 0 0 0 0 0 0 0 0 0 0 0 2 0 0 0 0 5 0 0 0 4 0 0 0 6 6 0 0 5 0 0 0 0 0 0 0 0 0 0 4 0 0 0 0 5 0 2
2 0 0 0 0 0 0 0 0 4 0 0 0 0 0 0 0 4 0 0 0 0 0 0 0 0 0 0 0 0 0 0 0 0 0 0 0 2 0 0 0 0 0 0 0 0 0 0 0 0 0 0 0 0 0 0 0 0 0 0 0 0 0 2 0 0 0 0 0 0 0 4 3 0 0 4 0 0 6 6 0 5 0 0 0 5 0 0 0 0 0 0 0 4 0 0 0 0 0 2
2 0 0 0 0 0 3 0 0 0 0 0 0 0 0 0 0 0 0 0 0 0 0 0 0 0 4 0 0 0 0 0 0 0 0 0 0 2 0 0 0 0 0 0 0 0 0 0 0 0 0 0 0 0 0 0 0 0 0 0 0 0 0 2 0 0 0 0 2 0 2 3 0 3 0 0 0 0 0 6 4 4 4 5 0 0 0 0 0 0 0 0 0 0 0 5 0 0 0 2
2 0 0 0 4 0 0 0 0 0 0 0 0 0 0 0 0 0 0 0 0 0 0 4 0 0 0 0 0 0 0 3 3 0 0 0 5 0 2 0 0 0 0 0 0 0 0 0 0 0 0 0 0 0 0 0 0 0 0 0 0 0 2 0 0 0 0 4 0 0 2 0 0 3 4 3 0 0 0 6 6 6 6 6 6 6 6 6 0 0 0 0 5 0 0 0 0 0 0 2
2 0 4 4 0 3 0 0 0 0 0 0 4 0 0 0 0 0 0 5 0 0 0 0 0 0 0 0 0 0 4 0 0 4 5 0 0 4 0 2 0 0 0 0 0 0 0 0 0 0 0 0 0 0 0 0 0 0 0 0 0 2 0 0 0 0 0 0 0 0 0 0 0 0 0 0 0 5 0 0 4 4 4 4 4 4 4 6 6 6 6 0 0 3 5 3 0 5 0 2
2 5 4 0 0 0 0 0 0 0 0 0 0 0 0 0 0 0 0 0 0 0 0 4 0 0 0 0 0 0 5 3 0 0 0 4 0 4 0 5 2 0 0 0 0 0 0 0 0 0 0 0 0 0 0 0 0 0 0 0 2 0 5 0 0 0 0 0 0 0 0 0 0 0 0 0 0 0 0 0 0 4 4 4 4 4 0 0 0 0 0 0 0 4 0 0 0 0 0 2
2 0 0 0 0 4 3 0 0 0 0 0 0 0 0 0 0 0 0 0 0 0 0 0 0 0 0 0 0 0 0 0 0 0 0 0 0 0 0 0 0 2 2 0 0 0 0 0 0 0 0 0 0 0 0 0 0 0 2 2 0 0 5 0 4 5 4 4 0 0 0 0 0 0 0 0 0 0 0 5 0 0 4 4 4 4 0 0 0 0 0 0 0 0 0 0 0 0 0 2
2 0 0 0 0 5 0 0 4 0 0 0 0 0 4 0 0 0 0 0 0 0 0 0 0 0 0 0 0 0 0 0 0 0 0 0 0 0 0 4 5 0 0 2 2 0 0 0 0 0 0 0 0 0 0 0 2 2 0 0 0 3 0 2 0 0 0 0 0 0 0 0 0 0 0 0 0 0 5 0 0 0 0 4 0 0 0 3 0 0 0 4 0 0 0 0 0 4 0 2
2 4 0 0 0 0 4 3 0 4 0 5 5 4 0 0 5 0 0 0 5 0 0 0 0 0 5 0 4 0 0 0 0 0 0 0 0 0 0 0 0 0 0 3 3 2 2 2 2 2 0 2 2 2 2 2 0 0 0 0 3 3 0 0 2 2 0 0 0 0 0 0 0 0 0 0 0 0 0 0 0 0 0 0 0 0 0 0 3 0 0 0 0 0 0 0 0 0 0 2
2 0 0 0 0 0 0 0 0 0 0 0 0 0 0 0 0 0 0 0 0 0 0 0 0 5 0 0 0 0 0 0 0 4 0 0 0 0 0 0 0 0 0 0 0 0 4 0 0 0 2 0 4 0 0 0 0 0 0 0 3 3 0 2 0 5 0 0 0 0 0 0 0 0 0 0 0 0 0 0 0 0 0 0 0 0 0 0 0 0 0 0 0 0 0 0 0 0 5 2
2 0 0 0 0 5 0 0 0 0 0 0 0 0 0 0 0 0 0 4 0 0 0 0 0 0 0 0 0 0 0 0 0 0 0 0 0 0 0 0 0 0 0 5 0 0 0 0 4 0 0 0 0 0 0 0 0 0 0 0 0 0 0 5 4 0 5 0 0 0 0 0 0 0 0 0 0 0 0 0 0 0 4 0 0 0 0 0 0 0 0 0 0 0 0 5 0 0 0 2
2 0 0 0 0 0 0 0 0 0 0 0 0 5 0 0 0 0 0 4 0 0 0 0 0 0 0 0 0 0 0 0 0 0 0 0 0 0 0 0 5 0 2 2 0 0 4 0 4 0 0 0 0 0 0 0 5 0 5 0 4 0 0 0 0 0 0 0 0 0 0 0 0 0 0 0 0 0 0 0 0 0 3 3 0 0 4 0 0 0 4 0 4 4 0 0 0 3 0 2
2 0 0 0 0 0 0 0 0 0 0 0 4 0 0 5 0 0 0 0 0 0 0 0 0 5 0 0 0 0 0 0 0 0 0 0 0 0 0 0 0 2 0 0 0 0 4 0 3 5 0 0 5 0 0 0 0 0 0 0 0 0 0 0 5 0 0 4 0 0 5 3 0 0 4 4 0 5 0 0 0 0 3 0 0 0 0 0 0 0 0 0 0 0 0 0 0 4 0 2
2 4 0 0 0 0 0 0 0 0 0 0 0 0 0 0 2 0 0 5 0 0 0 0 0 0 0 0 0 0 0 0 0 0 0 3 0 0 0 0 0 2 4 0 0 5 0 0 3 3 0 0 0 0 0 4 0 0 0 0 0 3 3 3 0 0 0 0 0 0 0 0 0 0 0 0 0 0 0 0 0 0 3 0 0 0 0 0 0 0 0 0 0 0 0 0 2 3 0 2
2 0 0 0 0 0 0 0 0 0 0 0 0 0 0 0 0 0 4 0 0 0 0 0 0 0 0 0 0 5 0 0 0 0 5 0 0 0 5 0 0 0 0 0 0 5 0 0 0 0 0 0 5 0 0 0 0 0 4 0 4 4 0 0 0 0 5 0 0 0 0 0 0 0 0 0 0 0 0 0 0 0 0 0 0 0 0 0 4 0 0 0 0 5 0 2 5 4 0 2
2 0 0 0 0 0 0 0 0 0 2 2 2 0 4 0 0 2 0 0 0 0 0 0 0 0 0 0 0 0 0 0 0 0 4 0 3 0 0 0 0 0 0 0 0 0 0 0 4 4 4 0 4 0 0 0 0 0 0 0 0 4 3 3 0 0 0 0 0 0 0 0 0 0 0 0 0 0 0 0 0 0 0 0 0 0 0 0 0 0 0 0 0 0 0 0 2 4 0 2
2 0 0 0 0 0 0 0 2 2 2 2 2 4 0 0 0 0 0 5 0 0 0 0 0 0 0 0 0 0 0 0 4 0 0 0 0 0 0 0 0 0 0 0 0 0 0 0 0 0 0 0 0 0 0 0 5 0 2 0 0 0 0 0 0 0 0 0 0 0 0 0 0 0 0 0 0 0 0 0 0 0 0 0 0 4 0 5 5 0 0 0 0 0 0 0 0 0 4 2
2 0 4 0 0 4 0 0 2 2 2 8 8 8 8 8 8 8 8 8 0 0 0 0 0 0 0 0 0 0 0 0 0 0 0 0 0 0 0 0 0 4 4 2 2 2 0 0 0 0 0 0 0 0 4 0 0 0 2 0 0 0 4 0 0 0 0 0 0 0 0 0 0 5 0 0 0 0 4 0 0 4 0 0 0 0 3 5 0 0 0 0 0 0 0 0 0 5 0 2
2 0 0 0 0 0 0 2 2 8 8 8 8 8 8 8 8 8 8 8 2 0 0 0 0 0 0 0 2 2 0 0 1 0 0 0 0 1 0 0 0 0 0 0 0 0 0 0 1 1 0 0 0 1 0 0 0 0 0 2 0 0 0 0 1 0 0 0 0 0 0 0 0 0 0 1 0 0 0 0 1 0 0 0 0 1 3 0 0 3 0 1 1 0 0 0 0 0 0 2
2 0 0 0 0 0 2 2 2 8 8 8 8 8 8 8 8 8 8 8 0 0 0 0 0 0 0 2 2 0 0 0 0 0 0 0 0 1 0 0 0 0 0 0 0 0 0 0 0 0 0 0 0 0 0 0 0 0 0 0 0 0 1 0 0 0 0 1 0 0 1 0 0 0 0 0 0 0 0 0 0 0 0 0 3 0 1 0 3 3 0 1 0 0 0 0 0 0 0 2
2 0 0 0 0 0 0 2 2 2 8 8 8 8 8 8 0 0 4 0 0 0 0 0 2 0 0 0 0 0 0 0 0 1 0 0 1 0 0 0 4 0 0 0 1 0 0 0 0 0 0 0 0 0 0 0 0 0 0 0 0 1 1 1 0 0 0 0 0 0 0 0 0 0 0 1 0 0 0 0 0 0 0 0 0 0 0 0 0 0 0 0 0 0 0 0 0 0 0 2
2 0 0 0 0 0 0 0 2 7 8 6 8 8 0 4 0 0 4 0 2 0 0 0 0 0 0 0 0 0 0 0 0 0 0 0 0 0 0 0 0 0 0 0 0 0 0 0 0 0 0 0 0 0 0 0 0 0 0 0 0 0 0 0 2 0 0 0 0 0 0 0 0 0 1 1 0 1 0 0 0 0 1 0 1 0 1 0 0 1 0 0 0 0 0 0 1 1 0 2
2 0 0 0 0 0 0 0 0 2 2 6 6 0 7 4 2 0 0 0 0 0 0 0 0 2 2 2 0 0 0 0 0 0 0 0 0 0 4 2 0 0 0 0 0 0 0 0 0 0 0 0 0 1 0 1 0 1 0 0 0 0 0 2 0 0 0 1 0 0 0 0 0 1 0 1 0 0 0 0 0 0 0 0 0 0 0 0 0 0 1 0 0 0 0 0 0 0 0 2
2 0 0 0 0 0 0 0 0 0 0 0 6 0 0 2 7 0 0 0 0 0 0 0 0 0 0 2 0 2 0 0 0 0 0 0 1 0 1 0 0 0 0 0 0 0 0 0 0 0 0 0 0 0 0 0 0 0 0 0 1 0 0 2 0 0 0 0 0 0 0 1 0 0 1 0 1 0 0 0 0 0 1 0 0 0 0 0 0 0 0 1 1 0 0 0 0 0 0 2
2 0 0 0 7 0 7 0 0 0 0 0 6 0 0 0 0 0 0 0 0 0 0 0 0 0 0 0 0 2 0 0 0 0 0 0 0 0 2 2 1 0 0 0 0 0 1 0 1 0 0 0 0 0 0 1 0 0 0 0 0 0 0 0 0 0 0 0 0 0 0 1 0 1 2 2 0 0 0 0 1 0 0 0 0 0 0 0 0 0 0 0 0 0 0 0 0 0 0 2
2 0 0 0 0 0 0 0 0 0 0 0 0 0 0 0 0 0 0 0 0 2 2 0 0 0 0 0 0 0 2 0 0 0 1 0 0 0 0 1 0 0 0 0 0 0 0 0 0 0 0 0 0 0 1 0 0 0 0 0 1 0 0 0 0 0 0 0 0 0 0 0 0 0 0 0 0 0 0 0 1 0 0 0 0 0 0 0 0 0 0 1 0 0 0 0 0 0 0 2
2 0 0 0 0 0 0 0 0 0 3 0 0 0 0 0 0 0 0 1 0 0 0 0 0 0 0 0 0 0 0 0 1 0 0 0 2 0 0 0 0 0 0 0 0 1 0 1 0 0 0 0 0 0 0 1 1 0 0 0 0 0 1 1 0 0 0 0 0 0 0 0 0 0 0 0 1 0 1 0 0 0 0 0 0 0 0 0 0 0 0 1 0 0 0 0 1 0 0 2
2 0 0 1 0 1 1 0 0 0 0 0 0 1 1 0 0 0 0 3 2 0 2 0 0 0 0 0 0 0 0 0 0 1 1 0 2 1 0 0 0 0 0 0 0 0 0 0 0 0 0 0 0 0 0 0 0 0 0 0 0 0 0 0 0 0 0 0 0 0 0 0 0 0 0 0 0 0 0 0 0 1 0 0 0 0 0 0 0 0 0 0 0 0 3 0 3 0 0 2
2 0 0 0 0 0 0 0 0 3 0 0 0 0 0 0 0 0 0 1 0 0 0 0 0 0 0 1 0 3 0 0 0 0 0 0 0 0 1 0 0 0 0 0 0 0 0 0 0 0 0 0 0 0 0 0 0 0 0 0 0 0 0 1 0 1 0 0 1 0 0 0 0 0 0 0 0 0 0 0 0 0 0 0 0 0 0 0 0 0 0 0 0 0 3 0 0 0 0 2
2 0 0 0 0 0 0 0 0 1 0 0 0 0 0 0 0 0 3 0 1 0 1 1 0 0 0 0 0 1 0 1 0 0 0 0 0 0 0 1 1 0 0 0 1 0 1 0 0 0 0 0 1 0 1 0 0 0 0 0 0 1 0 1 0 0 0 1 0 0 1 0 1 1 0 1 0 0 2 0 0 0 0 0 0 0 0 0 0 0 0 0 0 0 0 0 0 0 0 2
2 0 0 0 0 0 0 0 0 0 1 0 0 0 0 0 1 0 0 1 0 0 0 0 0 0 0 0 0 3 0 0 0 0 0 0 0 0 0 0 1 0 1 0 0 0 0 0 0 0 0 0 1 0 0 0 0 0 0 1 0 1 0 1 0 0 0 0 0 0 0 2 0 0 0 0 0 1 2 0 0 0 0 0 0 0 0 0 1 0 0 0 1 1 0 1 1 0 0 2
2 0 0 0 0 0 0 0 0 0 0 0 0 1 0 0 0 1 0 0 0 1 1 0 0 0 0 0 0 0 0 0 0 0 0 0 0 1 0 0 0 0 0 0 1 1 1 1 0 0 1 0 0 1 0 0 0 1 0 0 0 0 0 0 1 0 0 0 0 0 0 0 2 0 0 0 0 0 0 0 2 0 0 0 0 1 1 0 0 0 0 0 0 0 0 0 1 0 0 2
2 1 0 0 0 0 0 0 0 0 0 0 0 0 0 0 1 0 3 0 0 0 0 0 0 0 1 1 1 0 0 0 1 0 1 0 0 0 0 1 0 0 0 0 0 0 0 1 0 0 0 0 0 0 0 0 0 0 0 0 0 0 0 0 0 0 0 0 0 0 0 0 1 0 0 0 0 0 1 0 0 2 2 0 0 0 0 0 0 0 0 0 0 0 0 0 0 0 0 2
2 1 0 1 0 0 0 0 0 1 0 0 0 0 0 0 0 1 0 0 3 0 0 0 0 0 0 0 0 1 2 0 0 0 0 0 0 0 0 0 1 0 0 0 0 0 0 0 0 0 0 0 0 0 0 0 0 0 0 0 0 0 0 1 0 0 0 0 0 0 0 0 0 0 0 0 0 0 0 0 0 2 0 0 0 0 0 0 0 0 0 0 0 0 0 1 0 0 0 2
2 0 0 0 0 0 0 0 0 0 0 0 0 0 0 0 0 0 3 0 0 1 0 0 0 0 0 0 0 0 0 0 1 0 0 0 0 0 0 0 0 0 0 1 2 0 0 0 0 0 0 0 0 0 0 2 2 2 0 0 0 0 0 0 0 0 0 0 1 0 0 0 0 0 0 0 0 0 0 0 2 0 2 0 0 1 0 0 1 0 0 0 0 0 0 0 0 0 0 2
2 0 0 0 0 0 0 0 0 0 0 0 0 0 0 1 0 0 0 0 0 0 0 0 0 1 0 0 0 0 0 0 0 0 0 0 0 0 0 0 1 0 2 2 0 0 4 4 0 0 0 0 0 0 0 0 2 0 0 0 0 0 0 1 0 0 0 0 1 0 0 0 1 0 0 0 0 0 0 0 1 0 1 1 0 0 0 0 0 0 1 0 1 0 1 0 0 0 0 2
2 0 0 0 0 0 1 0 0 0 0 0 1 0 0 0 0 0 0 0 0 0 0 1 0 0 0 0 0 0 0 0 0 0 0 0 1 0 1 0 0 0 2 1 0 4 0 0 0 1 0 0 0 0 0 0 0 0 1 0 0 0 0 1 0 0 0 0 0 0 0 0 0 1 0 0 0 0 0 0 0 0 0 0 0 0 0 0 0 0 0 0 0 0 0 0 0 0 0 2
2 0 0 0 0 0 0 0 0 0 0 0 0 0 0 0 0 0 0 1 0 0 0 0 0 0 0 0 0 0 0 1 0 0 0 0 0 0 0 0 0 0 0 0 0 4 0 0 0 0 0 0 0 1 0 0 0 0 0 0 0 0 0 1 0 0 0 0 0 0 1 0 3 0 1 0 0 0 1 0 0 0 0 0 0 0 0 1 0 1 0 0 0 0 0 0 0 0 0 2
2 1 0 0 0 1 1 0 0 1 0 0 1 0 0 0 0 0 1 0 0 0 0 0 0 0 0 0 0 0 1 0 0 0 0 0 0 0 0 0 0 0 0 0 0 0 1 0 0 0 1 0 0 0 0 0 0 0 0 0 0 0 0 0 0 0 0 0 0 0 0 3 0 3 0 0 0 0 0 0 0 0 0 0 0 0 0 0 0 0 1 0 0 0 0 1 0 0 0 2
2 0 0 0 0 0 0 0 1 0 0 0 1 0 0 0 0 0 0 0 0 0 0 0 0 0 0 0 0 0 0 0 0 0 0 0 0 0 0 0 0 0 0 0 0 0 0 0 1 1 0 1 0 2 0 0 0 0 0 0 0 4 0 0 0 1 0 0 0 0 0 0 1 0 0 0 3 0 1 1 0 0 0 0 0 0 0 1 0 0 0 0 0 0 0 0 2 2 0 2
2 0 0 0 0 1 0 0 0 0 0 0 0 0 0 0 0 0 0 0 0 0 0 0 0 0 1 0 0 0 0 0 0 0 0 0 0 0 0 0 0 0 0 0 0 0 0 0 0 0 1 0 0 0 0 0 0 0 0 0 4 4 0 1 0 0 0 0 0 0 0 0 0 0 0 3 0 0 0 0 1 0 0 0 0 0 0 0 0 0 0 0 0 0 0 0 0 0 0 2
2 0 0 0 0 0 0 0 0 0 0 1 0 0 0 0 0 0 0 0 0 0 0 0 0 0 0 0 0 1 0 0 1 0 0 0 0 0 1 0 0 0 0 0 0 0 0 1 0 0 0 0 2 0 0 0 0 0 0 0 4 0 0 0 0 0 0 0 0 1 0 0 1 0 0 0 0 0 0 0 0 0 0 0 0 0 0 0 1 0 1 0 0 0 0 0 0 0 0 2
2 2 2 2 2 2 2 2 2 2 2 2 2 2 2 2 2 2 2 2 2 2 2 2 2 2 2 2 2 2 2 2 2 2 2 2 2 2 2 2 2 2 2 2 2 2 2 2 2 2 2 2 2 2 2 2 2 2 2 2 2 2 2 2 2 2 2 2 2 2 2 2 2 2 2 2 2 2 2 2 2 2 2 2 2 2 2 2 2 2 2 2 2 2 2 2 2 2 2 2
