0 0 0 0 0 0 0 0 0 0 0 0 0 0 0 0 0 0 4 0 0 0 0 0 0 0 0 0 0 0 0 0 0 0 0 0 0 0 0 0 0 0 0 0 3 0 0 0 0 0 0 0 0 0 0 0 0 0 0 0 0 0 0 0 0 0 0 0 0 0 0 0 0 0 0 0 0 0 0 0 0 0 0 0 0 0 0 0 0 0 0 0 0 0 3 0 0 0 0 0
0 0 0 0 0 0 0 0 0 0 0 0 0 0 0 0 0 0 0 0 0 0 0 0 0 0 0 0 0 0 0 0 0 0 0 0 0 0 0 0 0 0 0 0 0 0 0 0 0 0 0 0 0 0 0 0 0 0 0 0 0 0 0 0 0 0 0 0 0 0 0 0 0 0 3 0 0 0 0 0 0 0 0 0 0 0 0 0 0 0 0 0 0 0 0 0 0 0 0 0
0 0 0 0 0 0 0 0 0 0 0 0 0 0 0 0 0 0 0 0 0 0 0 0 0 0 0 0 3 0 0 0 0 0 0 0 0 0 0 0 0 0 0 0 0 0 0 0 0 0 0 0 0 0 0 0 0 0 0 0 0 3 0 0 0 0 0 0 0 0 0 0 0 0 0 0 0 0 0 0 0 0 0 0 0 0 0 0 0 0 3 0 0 0 0 0 0 0 0 0
0 0 0 0 0 0 0 0 0 0 0 0 7 0 0 0 0 0 3 0 0 0 0 0 0 0 0 0 0 0 0 0 0 0 0 0 0 0 0 3 0 0 0 0 0 0 0 0 0 0 7 0 0 0 0 0 0 0 0 0 0 0 0 0 0 0 0 0 0 0 0 0 0 0 4 0 0 0 0 0 0 0 0 0 0 0 0 0 0 0 0 0 0 0 0 0 0 0 0 0
0 0 0 0 0 0 0 0 0 0 0 0 0 0 0 0 0 0 4 0 0 0 0 0 0 0 0 0 0 0 0 0 0 0 0 0 0 0 3 0 0 0 0 0 0 0 3 0 0 0 0 0 0 0 0 0 0 0 0 0 0 0 0 0 0 0 0 0 0 0 0 0 0 0 0 0 0 0 0 0 0 0 0 0 0 0 0 0 0 0 0 0 0 0 0 0 0 0 0 0
0 0 0 0 0 0 0 0 0 0 0 0 0 0 0 0 0 0 0 3 0 0 0 0 0 0 0 0 0 0 0 0 0 0 0 0 0 0 0 0 0 0 0 0 0 0 0 0 0 0 0 3 0 0 0 0 0 3 0 0 0 0 7 0 0 0 0 0 0 0 0 0 7 0 0 0 0 0 0 0 0 0 0 0 0 0 0 0 0 0 0 0 0 0 0 0 0 0 0 0
0 0 0 0 0 0 0 0 0 0 0 0 0 0 0 0 0 0 0 4 0 0 0 0 0 0 0 4 0 0 0 0 0 0 0 0 0 0 0 0 0 0 0 3 0 0 0 0 0 0 0 0 0 0 0 0 0 0 0 0 0 0 0 3 0 0 0 0 0 0 0 0 0 7 0 0 0 0 0 8 8 8 8 8 0 0 0 0 0 0 0 0 0 0 0 0 0 0 0 0
0 0 0 0 0 0 0 0 0 3 0 0 0 0 0 0 0 0 0 0 0 0 0 0 0 0 0 0 0 0 0 0 0 0 0 0 0 0 0 0 0 0 0 0 0 0 0 0 0 0 0 0 0 0 0 0 0 0 0 0 0 0 0 0 0 0 0 0 0 0 7 0 0 0 0 0 0 0 0 8 8 8 8 8 8 8 8 8 0 0 0 0 0 0 0 0 0 0 0 3
0 0 0 0 0 0 0 0 0 0 0 0 0 0 0 0 0 0 0 0 0 0 0 0 0 0 0 0 0 0 0 0 0 0 0 0 0 0 0 0 0 0 0 0 0 0 0 0 0 0 0 3 0 0 0 0 0 0 0 0 0 0 0 0 0 0 0 0 0 0 0 0 0 0 0 0 0 0 0 8 8 8 8 8 8 8 8 8 0 7 0 0 3 0 0 0 0 0 0 0
0 0 0 7 0 0 0 0 0 0 0 0 0 0 0 0 0 0 0 0 0 0 0 0 0 0 0 0 0 0 0 0 0 7 0 0 0 0 0 0 0 0 0 0 0 0 0 0 0 0 0 0 0 0 0 0 0 0 0 4 0 0 0 0 0 0 0 0 0 0 0 0 0 0 0 0 0 0 0 8 8 8 8 8 0 0 0 0 0 0 0 0 0 0 0 0 0 0 0 0
0 0 0 0 0 0 0 0 0 0 6 6 6 0 6 6 6 0 0 6 6 6 0 6 6 6 0 6 4 0 6 6 6 6 6 6 6 6 0 6 0 6 0 6 6 0 0 6 6 6 0 6 6 0 6 6 6 6 6 0 6 6 6 0 6 0 6 0 6 6 0 6 0 6 0 6 6 0 6 8 8 8 8 8 8 8 8 6 0 0 0 0 0 0 0 0 0 0 0 0
0 0 0 0 0 0 0 0 0 0 0 0 0 0 0 0 0 0 0 0 0 0 0 0 0 0 0 0 0 0 0 0 0 0 0 0 0 0 0 0 4 0 0 0 0 0 0 0 0 0 0 0 0 0 0 0 0 0 0 0 0 0 0 0 0 0 0 0 0 0 0 0 4 0 0 0 0 0 0 8 8 8 8 8 8 0 0 0 0 0 0 0 0 0 0 0 0 0 0 0
0 0 0 0 0 0 0 0 0 0 0 0 0 0 0 0 0 0 0 0 0 0 0 0 0 0 0 0 0 0 0 0 0 0 0 0 0 0 0 0 0 0 0 0 0 0 0 0 0 0 0 0 0 0 0 0 0 0 0 0 0 0 0 0 0 0 0 0 0 0 0 0 0 0 0 3 0 0 0 8 8 8 8 8 8 8 8 8 8 8 8 8 8 0 0 0 0 0 0 0
0 0 0 0 0 4 0 0 0 0 0 0 0 0 7 0 0 0 0 0 0 0 0 0 0 0 0 0 0 0 0 0 0 0 0 0 0 0 0 0 0 0 0 0 0 0 0 0 0 0 0 0 0 0 0 0 0 0 0 0 3 0 0 0 0 0 0 0 0 0 0 0 0 0 0 0 0 3 0 8 8 8 8 8 8 8 8 8 8 8 0 0 0 0 0 0 0 0 0 0
0 0 0 0 0 0 0 3 0 0 0 0 0 0 0 0 0 0 0 0 0 0 0 0 0 0 0 0 0 0 0 0 0 0 0 0 0 0 0 0 0 0 0 0 0 0 0 0 0 3 0 0 0 0 0 0 0 0 0 0 0 3 0 0 0 0 0 0 0 0 0 0 0 0 0 0 0 0 0 8 8 8 8 8 0 0 0 0 0 0 0 0 0 0 0 0 0 0 0 4
0 0 0 0 0 0 0 0 0 0 0 0 0 4 0 0 0 0 0 0 0 0 0 0 0 0 0 0 0 0 0 0 0 0 0 0 0 0 0 0 0 0 0 0 0 0 0 3 0 0 0 0 0 0 0 0 4 0 0 0 0 0 0 0 0 0 0 0 0 0 0 0 0 0 4 0 0 0 0 8 8 8 8 8 8 8 8 8 8 8 8 0 0 0 0 0 0 0 0 0
0 0 0 0 0 0 0 0 0 0 0 0 3 0 0 0 0 0 0 0 0 0 0 0 0 0 0 0 0 0 0 0 0 0 0 0 0 0 0 0 0 0 0 0 0 0 0 4 0 0 0 0 4 0 0 0 0 0 0 0 0 0 0 0 0 0 0 0 0 0 0 0 0 0 0 0 0 0 0 8 8 8 8 8 8 8 8 8 8 8 8 0 0 0 0 0 0 0 0 0
0 0 0 0 0 0 0 0 0 0 0 0 0 0 0 0 0 0 0 0 0 0 0 0 0 0 0 0 0 0 0 0 0 0 0 0 0 0 0 0 0 0 0 0 0 0 0 0 0 0 0 0 0 0 0 0 0 0 0 0 0 3 0 0 0 0 0 0 7 0 0 0 0 0 0 0 0 0 0 8 8 8 8 8 8 8 8 8 8 8 8 0 0 0 0 0 0 0 0 0
0 0 0 0 0 0 0 0 0 0 0 0 0 4 0 0 0 0 0 0 0 0 0 0 0 0 3 0 0 0 0 0 0 0 3 0 0 0 0 0 0 0 0 0 0 0 0 0 0 0 7 0 0 0 0 0 0 0 0 0 0 3 0 0 0 0 0 0 0 0 0 0 0 0 0 0 0 0 0 8 8 8 8 8 8 8 0 0 0 7 0 0 0 0 0 0 0 0 0 0
0 0 0 0 0 0 0 0 0 0 0 0 0 0 0 0 0 0 0 0 0 0 0 0 0 0 0 0 0 0 0 0 0 0 0 0 0 0 0 0 0 0 0 0 0 0 0 0 0 0 0 0 0 0 0 0 0 0 0 0 0 0 3 0 0 0 0 0 0 0 0 0 0 0 0 0 0 0 0 8 8 8 8 8 8 8 8 8 8 0 0 0 0 0 0 0 0 0 0 0
0 0 0 0 0 0 0 0 0 0 6 0 6 6 6 6 6 6 0 6 6 6 6 6 2 6 6 6 6 0 6 6 6 6 6 2 2 6 2 0 5 6 2 6 2 0 6 6 6 6 6 6 6 6 2 6 6 6 6 6 0 6 6 2 6 6 6 6 6 6 2 6 6 6 6 6 6 0 6 8 8 8 8 8 8 6 6 6 6 0 0 0 0 0 0 0 0 0 0 0
0 0 0 0 0 0 0 0 0 0 0 0 0 0 0 3 0 0 0 0 0 2 2 0 0 0 0 0 0 2 2 0 2 0 0 0 0 2 0 5 0 0 3 0 5 2 3 2 0 0 2 0 2 0 0 2 0 0 0 2 0 0 3 2 0 0 2 0 0 2 0 2 0 0 0 0 2 7 2 0 0 0 0 0 0 0 0 0 0 0 0 0 0 0 0 0 0 0 0 0
3 0 0 0 0 0 0 0 0 0 0 0 0 0 0 0 0 0 0 0 0 0 0 0 2 0 2 0 2 0 2 0 0 0 2 0 2 0 2 2 2 2 0 2 2 0 2 0 0 0 0 0 2 2 2 2 2 5 2 2 2 0 2 0 2 0 2 0 0 2 0 0 2 7 2 0 2 2 0 2 0 0 0 0 0 0 0 0 0 0 0 3 0 0 0 0 0 0 0 0
0 0 0 0 0 0 3 0 0 0 0 0 0 0 0 0 0 0 0 0 0 5 0 2 2 0 0 2 5 2 0 0 0 0 0 0 2 2 0 2 2 2 0 2 0 0 0 2 2 2 2 0 2 0 2 2 0 2 2 2 2 2 0 2 2 2 0 0 5 2 2 2 2 2 2 0 0 2 0 2 0 0 0 0 0 0 0 0 0 0 0 0 0 0 0 0 0 0 0 0
0 0 0 0 0 0 0 0 7 0 0 0 0 0 0 0 0 0 0 0 0 2 0 0 2 0 2 0 5 2 2 0 3 2 0 2 0 2 0 0 2 0 5 2 2 2 2 0 2 2 0 2 2 2 2 2 2 2 0 2 3 2 2 2 2 2 2 5 2 0 0 0 0 2 2 2 0 2 2 2 0 0 0 0 0 0 7 0 0 0 0 0 0 0 0 0 0 0 0 0
0 0 0 3 0 0 0 0 3 0 0 0 0 0 0 0 0 0 0 0 0 0 2 0 2 2 0 2 2 0 2 0 0 0 5 0 2 0 0 2 2 0 0 2 2 2 2 0 0 2 0 0 2 0 0 2 0 2 2 5 2 5 0 5 2 2 0 0 2 2 2 2 0 2 0 0 0 2 2 2 0 0 0 0 0 0 0 0 0 0 3 0 0 0 0 0 0 0 0 0
0 0 0 0 0 0 0 0 0 0 0 0 0 3 0 0 0 0 0 0 2 2 2 2 0 2 0 2 0 2 2 0 0 0 2 2 2 2 0 2 2 2 0 0 0 0 0 2 0 2 2 0 2 0 0 0 0 2 0 2 2 2 2 0 2 5 2 0 2 2 2 0 2 0 0 2 2 2 0 0 3 0 3 0 0 0 0 0 0 0 0 0 0 0 0 0 0 0 0 0
0 0 0 0 0 0 0 0 0 0 0 0 0 0 0 0 0 0 0 0 0 0 0 2 2 0 2 2 0 5 4 0 0 2 2 0 0 0 0 0 2 0 2 0 3 0 2 2 2 2 2 2 2 2 2 2 0 2 0 0 2 2 0 2 0 2 2 2 2 2 2 2 0 0 0 2 2 0 0 2 4 0 0 0 0 0 0 0 3 0 0 0 0 0 0 0 0 0 0 0
0 0 0 7 0 4 0 0 0 0 0 0 0 0 0 0 0 0 0 0 0 5 0 5 0 0 2 2 0 2 0 0 0 2 2 0 2 0 0 0 2 2 2 2 2 2 0 2 2 2 2 0 0 2 2 0 0 0 0 0 2 2 0 0 2 0 0 2 2 2 2 0 2 0 2 0 2 0 0 2 0 0 0 0 0 0 0 0 0 0 0 0 7 0 0 0 0 0 0 0
0 0 0 0 0 0 0 0 0 0 0 0 0 0 0 0 0 0 0 0 2 0 0 0 0 0 2 0 0 2 2 0 0 0 0 2 0 0 0 2 2 0 2 0 2 2 0 0 2 5 2 0 0 2 2 5 0 0 2 0 0 2 0 5 0 0 0 2 0 0 0 0 2 2 0 0 0 2 0 0 0 0 0 0 0 0 0 0 0 0 0 0 0 0 0 0 0 0 0 0
0 0 0 0 0 0 0 0 0 0 6 6 0 0 6 6 0 6 6 0 6 2 6 6 2 6 6 6 0 2 6 6 0 6 6 6 2 6 6 2 6 6 6 6 6 2 6 2 2 0 0 6 6 6 0 6 2 6 6 6 6 6 2 6 6 2 6 0 6 6 5 6 6 2 6 6 6 6 6 6 6 0 7 6 0 0 6 0 6 0 0 0 0 0 0 0 0 0 0 0
0 0 0 0 0 0 0 0 0 0 0 0 0 0 0 0 0 0 0 0 0 0 2 0 5 2 0 2 2 2 2 2 2 2 2 2 0 0 0 2 2 0 0 0 0 0 2 0 2 2 2 0 0 2 2 2 2 0 2 2 2 2 2 2 5 0 2 2 0 2 0 0 2 2 2 2 0 0 2 7 0 0 0 0 0 0 0 0 0 0 0 0 0 0 0 0 0 0 0 0
0 0 0 0 0 0 0 0 0 0 0 0 0 0 0 0 0 0 0 3 2 0 2 2 0 2 0 0 2 0 0 0 0 2 2 2 0 2 0 0 2 2 2 2 2 0 0 5 0 2 2 2 0 0 0 2 2 0 2 0 0 2 0 0 0 2 2 2 2 2 2 0 2 0 0 0 2 2 0 0 0 0 0 4 0 0 0 0 0 0 0 0 0 0 0 0 0 0 0 0
0 0 0 0 0 0 3 0 0 7 0 0 0 0 0 0 0 4 0 0 0 0 2 2 2 0 5 0 2 2 2 0 2 2 0 2 0 0 0 0 0 0 0 2 2 2 2 0 0 2 2 0 2 0 0 2 0 0 2 0 2 2 0 2 0 2 2 2 2 2 0 7 2 0 2 0 2 2 2 5 0 0 0 0 0 0 0 0 0 0 0 3 0 0 0 0 0 0 0 0
0 0 0 3 0 0 0 0 0 0 0 0 0 0 0 0 0 0 0 0 0 2 2 0 2 5 2 0 0 0 2 0 0 0 2 2 2 0 2 0 0 2 2 2 2 2 0 2 0 2 0 0 0 2 5 2 0 2 5 2 0 0 0 0 2 2 5 2 2 0 0 0 0 0 2 0 2 2 0 2 0 0 0 0 0 0 0 0 0 0 0 0 0 0 0 0 0 0 0 0
0 0 0 0 0 0 0 0 0 0 0 0 0 0 0 0 0 0 0 0 0 2 2 0 2 2 2 2 4 2 0 0 0 2 0 2 2 0 0 5 2 2 5 0 2 0 2 0 2 2 2 0 2 2 0 0 2 2 0 2 3 2 5 0 2 2 2 2 2 0 2 2 0 2 2 0 2 0 0 2 0 0 0 0 0 0 0 0 7 0 0 0 3 0 0 0 0 0 0 0
0 7 0 0 0 0 0 0 0 0 0 0 0 0 0 0 0 0 0 0 2 0 2 0 2 2 0 0 2 0 2 2 5 2 2 2 4 2 0 0 0 2 0 0 7 0 0 0 2 5 0 2 0 0 0 2 2 0 0 0 0 0 2 0 0 2 2 0 5 2 0 5 0 0 0 2 2 0 0 0 0 0 0 0 0 0 0 0 0 0 0 0 0 0 0 0 0 0 0 0
0 0 0 0 4 0 0 0 0 0 0 0 0 0 0 0 0 0 0 0 2 5 0 2 8 8 8 8 8 8 8 8 8 8 8 8 8 8 2 0 2 2 0 0 0 2 2 2 0 2 0 0 0 0 2 0 2 0 2 0 0 2 0 2 0 2 0 2 2 2 0 2 0 0 0 2 0 0 0 0 0 0 0 0 0 0 0 0 0 0 0 0 0 0 0 0 4 0 0 0
0 0 0 0 0 0 0 0 0 0 0 0 0 0 0 0 0 0 0 0 2 0 0 2 8 8 8 8 8 8 8 8 8 8 8 8 8 8 2 0 0 2 2 2 0 0 2 2 2 2 0 2 0 7 2 2 2 2 2 0 2 0 0 3 0 2 0 0 2 0 0 0 0 2 2 2 0 2 2 2 0 0 0 0 0 0 0 0 0 0 0 0 0 0 0 0 0 0 0 3
0 0 0 0 0 0 0 0 0 0 0 0 0 0 0 0 0 0 0 0 2 2 2 2 8 8 8 8 8 8 8 2 0 2 0 2 0 2 2 2 2 2 2 2 2 2 2 0 2 2 0 2 2 0 0 0 2 7 2 2 2 2 0 2 3 2 2 0 0 0 2 0 0 0 0 5 0 0 2 0 0 0 0 0 0 0 0 0 0 0 3 0 0 0 0 0 0 0 0 0
0 0 0 0 0 0 0 0 0 0 0 6 0 6 6 6 6 6 0 6 6 6 4 6 8 8 8 8 8 8 6 2 6 2 6 6 6 0 6 6 6 6 2 6 6 6 6 6 6 0 6 6 6 6 6 2 6 6 6 6 6 0 6 6 6 6 6 6 0 6 6 0 0 2 6 6 2 6 2 6 6 6 0 6 6 6 0 0 6 6 0 0 3 0 0 0 0 0 0 0
0 0 0 0 0 0 0 0 0 0 0 0 7 0 0 0 0 0 0 0 2 2 5 0 8 8 8 8 8 8 0 2 2 2 2 0 2 0 0 0 2 2 0 0 2 2 0 2 2 0 0 0 0 0 0 2 2 2 0 0 0 0 0 2 0 0 2 2 2 2 2 0 2 0 5 0 0 2 2 2 0 0 0 0 0 0 0 0 0 0 0 0 0 0 0 0 0 0 0 0
0 0 8 8 8 8 8 8 8 8 8 8 8 0 0 0 0 0 0 0 2 2 2 0 8 8 8 8 8 2 5 0 0 0 0 3 2 2 2 0 0 2 2 2 2 2 0 0 0 2 5 2 0 2 0 0 2 0 2 0 0 2 0 0 2 0 3 2 2 2 2 2 0 0 0 2 2 2 0 0 0 0 0 0 3 0 0 0 0 0 0 0 0 0 3 0 0 0 0 0
0 0 8 8 8 8 8 8 8 0 0 0 0 0 0 0 0 0 0 0 0 0 2 3 8 8 8 8 8 8 8 8 8 2 2 2 2 0 2 2 0 0 0 0 4 2 0 2 2 0 2 0 2 0 2 0 0 5 2 0 2 0 2 0 0 2 2 2 0 0 2 2 2 2 0 0 0 2 2 2 0 0 0 0 0 0 0 0 0 7 0 0 0 0 0 0 0 0 0 0
0 0 8 8 8 8 8 8 8 8 8 8 0 0 0 0 0 0 0 0 0 2 2 2 8 8 8 8 8 8 8 8 8 8 8 8 8 8 8 0 2 2 0 0 2 2 2 2 2 4 0 0 2 2 0 0 5 5 2 2 2 2 0 2 0 2 5 2 0 2 2 0 0 2 0 2 2 2 2 2 0 0 0 0 0 0 0 0 0 0 0 0 0 0 0 0 0 0 0 0
0 0 8 8 8 8 8 8 8 8 8 0 0 0 0 0 0 0 0 0 0 2 2 5 8 8 8 8 8 8 8 8 8 8 8 8 8 8 8 2 2 2 5 2 0 2 0 0 2 0 0 2 2 2 2 4 2 0 2 0 2 0 0 2 2 0 2 0 2 0 2 2 2 2 2 2 2 0 2 2 0 0 0 0 0 0 0 0 0 0 0 0 0 0 0 0 0 0 0 3
3 0 8 8 8 8 8 8 0 0 0 0 0 0 0 0 0 0 0 0 0 2 2 0 8 8 8 8 8 2 2 2 0 0 0 0 0 0 5 2 2 2 2 2 5 2 2 0 2 0 0 2 2 0 2 2 5 0 0 0 0 0 2 2 2 2 0 0 0 0 2 0 0 2 5 5 0 2 2 2 0 0 0 0 0 0 0 0 0 0 0 0 0 0 0 0 0 0 0 0
0 0 8 8 8 8 8 8 0 0 0 0 0 0 0 0 0 0 0 0 0 0 0 2 8 8 8 8 8 8 8 8 8 8 8 8 2 0 5 0 2 0 0 2 2 0 2 2 2 2 0 0 2 2 0 2 0 0 0 0 0 2 2 0 2 2 0 2 2 2 7 0 2 0 0 2 0 3 2 2 0 0 0 0 0 0 0 0 0 0 0 0 0 0 0 0 0 0 0 0
0 0 8 8 8 8 8 8 8 8 8 8 8 8 0 0 0 0 0 0 0 2 0 0 8 8 8 8 8 8 8 8 5 2 2 2 0 2 5 2 2 2 2 0 0 2 0 2 2 2 2 0 2 2 0 2 0 0 2 0 0 0 0 0 2 2 2 0 2 2 0 0 0 0 0 2 0 2 0 2 0 0 0 0 0 0 3 0 0 0 0 0 0 0 0 0 0 0 0 7
0 0 8 8 8 8 8 8 8 0 0 0 0 0 0 0 0 0 0 0 0 0 0 2 8 8 8 8 8 8 8 0 2 0 2 0 0 0 2 3 2 2 2 2 2 0 2 0 2 0 2 2 0 0 0 2 0 0 2 0 2 2 5 2 0 5 0 0 0 2 2 2 3 2 2 0 0 0 2 0 0 0 0 0 0 0 0 0 0 0 0 0 3 0 0 0 3 0 0 0
0 0 0 0 0 0 7 0 0 0 6 6 6 6 6 0 6 6 6 0 6 0 6 6 2 6 6 6 6 6 6 0 6 6 2 0 0 0 6 6 6 5 6 6 6 6 6 6 6 6 2 2 6 6 0 2 2 6 6 2 2 6 2 6 6 6 3 6 6 2 6 6 0 6 0 5 6 6 0 0 0 0 0 6 6 6 6 6 6 6 0 0 0 0 0 0 0 0 0 0
0 3 0 0 0 0 0 0 0 0 0 0 0 0 0 0 0 0 0 0 0 2 0 2 0 2 0 5 2 2 0 2 2 0 0 2 0 0 0 2 2 2 5 2 2 0 0 2 2 2 0 5 0 5 0 0 8 8 8 8 8 8 8 8 8 8 8 0 2 0 2 0 0 2 0 2 0 2 0 0 0 0 0 0 0 0 0 0 0 3 0 0 0 0 0 0 0 0 0 0
0 0 0 0 0 0 0 0 0 0 0 0 7 0 0 0 0 0 0 0 2 0 2 2 2 2 0 5 0 2 2 0 0 0 0 2 0 0 0 0 0 0 0 2 2 2 2 0 0 0 2 2 0 0 2 0 8 8 8 8 8 8 8 0 0 2 2 0 0 0 2 0 0 0 2 7 0 2 2 2 0 0 0 0 0 0 0 0 0 0 0 0 0 0 0 0 0 0 0 0
0 0 0 0 0 0 3 0 0 0 0 0 0 0 0 0 0 0 0 0 2 2 2 0 0 0 2 2 2 2 0 0 2 0 5 0 2 2 2 0 2 0 2 4 0 0 2 2 2 0 0 2 2 5 2 2 8 8 8 8 8 8 8 8 8 8 8 8 8 8 8 0 0 0 2 0 0 2 0 2 0 0 0 0 7 0 0 0 0 0 0 0 0 0 0 0 0 0 0 0
0 0 0 0 0 0 0 0 0 0 0 0 0 0 0 0 0 0 0 0 0 2 0 2 0 0 0 0 2 2 2 2 0 0 2 5 0 2 2 0 0 2 0 2 2 2 2 2 2 2 0 0 4 2 0 0 8 8 8 8 8 8 8 8 8 8 8 8 8 8 2 2 0 2 7 0 2 0 0 0 0 0 0 0 0 0 0 0 0 0 0 0 0 0 0 0 0 0 0 0
0 0 0 0 0 0 0 4 0 0 0 7 0 0 0 0 0 0 0 0 0 0 5 2 2 0 2 2 0 2 2 2 2 2 2 0 2 2 2 2 2 2 2 0 2 2 2 2 0 2 2 2 0 2 5 2 8 8 8 8 8 8 8 8 8 8 8 8 8 8 2 2 2 2 2 0 2 2 2 2 0 0 0 0 0 0 0 0 0 0 7 0 0 0 0 0 0 0 3 0
0 0 0 0 0 0 0 0 0 0 0 3 0 0 0 0 0 0 0 0 2 2 2 2 0 2 2 2 0 0 3 2 2 2 2 5 0 2 2 0 2 2 5 0 5 0 2 3 0 0 2 2 2 0 0 0 8 8 8 8 8 8 8 8 8 8 8 8 8 8 0 2 2 2 0 2 0 0 2 2 0 0 0 0 0 0 0 0 0 0 0 0 0 0 0 0 0 0 0 0
0 0 0 0 0 0 0 0 0 0 0 0 0 0 0 0 0 0 0 0 0 0 2 2 2 3 0 2 2 0 0 2 2 5 0 2 2 0 0 2 2 0 0 2 0 0 2 0 0 2 2 3 0 2 0 0 8 8 8 8 8 8 8 8 8 8 8 8 8 8 8 0 2 0 0 2 0 2 2 2 0 0 0 0 0 0 0 0 0 7 3 0 0 0 0 0 0 0 0 0
0 0 0 0 0 0 7 0 0 0 0 0 0 0 0 0 0 0 0 0 2 2 2 5 0 2 0 0 2 0 2 2 2 0 2 0 0 0 2 2 2 2 2 0 2 2 5 2 0 0 2 0 2 2 2 2 8 8 8 8 8 8 2 5 0 2 2 2 2 2 2 0 2 2 0 2 0 2 2 5 0 0 0 0 0 0 0 0 0 0 0 0 7 0 0 0 0 0 0 0
0 0 0 0 0 0 0 0 0 0 0 0 0 0 0 0 0 0 0 0 2 2 5 0 0 2 0 2 2 2 0 2 2 2 0 0 0 2 0 0 2 2 0 0 2 2 2 0 2 0 2 0 2 2 2 0 8 8 8 8 8 8 8 8 8 8 5 0 2 0 2 2 2 2 2 4 0 2 2 5 0 3 0 0 0 0 0 0 0 0 0 0 0 0 0 0 3 0 0 0
0 0 4 0 0 0 0 0 0 0 6 6 6 0 0 6 6 6 6 0 0 6 6 6 6 6 6 6 6 6 2 6 6 6 6 0 6 6 6 6 6 6 6 6 2 0 6 6 6 0 6 6 6 6 6 6 8 8 8 8 8 8 8 8 2 6 6 6 6 6 6 6 0 6 6 6 0 6 6 0 0 6 6 6 6 6 0 6 6 6 0 0 0 0 0 3 0 0 0 0
0 0 0 0 0 0 0 0 0 0 0 0 0 0 0 0 0 0 0 0 2 2 0 2 0 0 2 2 2 0 0 2 0 2 7 2 0 2 0 0 2 2 0 0 2 2 2 5 0 2 2 2 0 0 0 2 8 8 8 8 8 2 0 0 2 2 0 0 2 0 0 2 5 2 0 0 2 0 0 0 0 0 0 0 0 7 0 0 0 0 0 0 0 0 0 0 0 0 0 0
0 0 0 0 0 0 0 0 0 0 0 0 0 0 0 0 0 0 0 0 0 0 2 0 0 0 0 5 2 2 0 2 0 0 0 0 2 2 2 0 2 2 0 0 0 2 0 0 2 2 0 0 2 3 2 0 8 8 8 8 8 8 8 0 0 0 0 2 2 0 2 5 0 2 0 0 2 2 0 0 0 7 0 0 0 0 0 0 0 0 0 0 0 0 0 0 0 0 0 3
0 4 0 0 0 3 0 0 0 0 0 0 0 0 0 0 0 0 0 0 2 0 0 0 0 2 2 5 2 0 2 0 0 5 2 5 2 0 0 2 2 0 0 2 2 2 0 7 2 2 0 2 2 0 0 2 8 8 8 8 8 8 2 2 2 2 0 0 2 2 0 0 2 0 0 2 2 2 2 0 0 0 0 0 0 0 0 4 0 0 0 0 0 0 0 0 0 0 0 0
0 0 0 0 0 3 0 0 0 0 0 0 0 3 0 0 0 0 0 0 0 2 2 2 2 2 2 2 0 2 0 2 0 0 2 3 5 0 2 2 2 2 0 2 0 2 0 4 0 2 2 0 2 0 2 2 8 8 8 8 8 8 8 8 2 2 0 2 2 2 0 2 2 2 2 0 0 0 2 0 0 0 0 0 0 0 0 0 0 0 0 0 0 0 3 0 0 0 0 0
0 0 0 0 0 0 0 0 0 0 0 0 0 0 4 0 0 0 0 0 0 0 5 2 0 0 0 2 2 2 2 2 0 0 0 7 2 0 2 2 0 0 2 2 2 0 2 2 2 0 0 0 2 0 0 0 8 8 8 8 8 8 8 8 8 2 0 5 2 0 0 2 0 2 2 0 2 2 0 0 0 0 0 0 0 0 0 0 0 0 0 0 0 0 0 0 4 0 0 0
0 0 0 0 7 0 0 0 0 0 0 0 0 0 0 0 0 0 0 0 0 0 0 0 3 2 2 0 2 0 0 2 2 0 0 0 0 2 0 2 0 2 2 2 2 2 0 0 2 2 2 0 0 0 5 0 2 0 2 2 2 2 0 0 2 2 2 0 2 0 0 2 0 0 0 2 2 0 2 0 4 0 0 0 0 0 0 0 0 0 3 0 0 0 0 0 0 0 0 0
0 0 0 0 0 0 0 0 0 0 0 0 0 0 0 0 0 0 0 0 0 0 0 2 5 0 0 2 2 2 2 2 0 2 2 0 0 0 2 0 2 2 0 2 0 0 2 0 5 2 2 2 0 0 0 2 0 2 0 2 2 2 2 0 2 0 7 2 0 0 2 0 0 0 7 2 2 0 0 2 0 0 0 3 0 0 0 7 0 0 0 0 0 0 0 0 0 0 0 0
0 0 0 0 0 0 0 0 0 0 0 0 0 0 0 0 0 0 0 0 5 0 2 2 2 2 5 0 0 2 2 2 2 0 0 0 2 0 2 0 2 0 2 2 2 2 2 0 0 2 2 0 0 2 0 2 2 2 0 0 0 2 2 0 2 0 2 0 2 2 2 0 2 2 2 0 2 0 0 0 0 0 0 0 0 0 0 0 0 0 0 0 0 0 0 0 0 0 0 0
0 0 0 0 0 0 0 0 0 0 0 0 0 0 0 0 0 0 0 0 0 2 2 5 2 0 0 0 2 0 0 2 2 2 2 2 0 2 2 2 0 2 0 2 2 0 0 0 0 2 0 0 5 2 2 0 2 0 2 0 0 2 0 0 0 0 0 0 0 0 2 0 0 0 2 2 0 2 2 0 0 0 0 0 0 0 0 0 0 0 0 0 0 0 0 0 0 0 0 0
0 0 0 0 0 0 0 0 0 0 0 0 0 6 6 6 6 6 6 6 6 6 2 6 2 6 6 6 6 0 0 3 6 6 2 6 6 6 6 2 6 6 6 6 6 6 0 0 2 2 6 0 6 6 2 6 6 0 6 6 0 6 2 2 6 6 6 5 0 6 6 0 6 6 6 6 6 6 6 6 6 0 0 0 6 0 6 0 0 6 0 0 0 0 0 0 0 0 0 0
0 0 0 0 0 0 0 0 0 0 0 0 0 0 0 0 0 0 0 0 2 2 0 2 2 0 2 2 2 0 0 0 2 2 2 2 2 2 2 2 5 2 0 2 2 2 5 0 2 2 2 2 0 0 2 0 2 0 2 2 2 0 2 2 0 0 2 2 2 2 0 2 2 0 2 2 0 2 2 0 0 0 0 0 0 0 0 0 0 0 0 0 3 0 0 0 0 0 0 0
0 0 0 0 0 0 0 0 0 0 0 0 0 0 0 0 0 0 0 0 0 0 2 2 2 2 0 0 2 2 2 2 2 2 0 2 0 2 5 2 2 2 0 0 2 5 3 2 0 0 0 0 7 0 2 2 0 2 0 2 2 0 2 2 2 0 0 0 2 0 0 0 0 2 0 0 0 0 2 0 0 0 3 0 0 0 0 0 0 0 0 0 0 0 0 0 0 3 0 0
0 0 0 3 0 0 0 0 0 0 0 0 0 0 0 0 0 0 0 0 2 2 0 0 0 0 2 2 0 0 0 5 2 2 5 2 2 2 0 2 2 0 0 2 0 2 0 0 2 2 2 2 0 2 0 0 2 2 0 2 0 5 2 0 2 2 3 2 2 0 2 0 2 0 5 0 2 2 2 0 0 0 0 0 0 0 0 0 0 0 0 0 7 0 0 0 0 0 0 0
0 0 0 0 0 0 0 0 0 0 0 0 0 0 0 0 0 0 0 0 2 2 2 2 2 5 0 2 0 0 2 2 0 2 0 2 0 0 2 0 0 0 2 0 2 2 0 0 2 0 0 2 2 0 2 2 2 0 2 0 0 7 0 0 0 0 2 2 2 2 2 2 2 2 2 0 0 0 5 2 0 0 0 0 0 0 0 0 0 0 0 0 0 0 0 0 0 0 0 0
0 0 3 0 0 0 0 0 0 0 0 0 0 0 0 0 0 0 0 0 0 2 2 5 4 0 0 2 2 5 2 2 0 2 0 0 2 2 0 2 0 2 0 0 0 2 2 2 2 2 2 0 0 5 0 0 0 2 2 2 2 0 0 0 0 0 2 0 0 0 0 0 2 0 2 2 2 0 0 0 0 0 0 0 0 0 0 0 0 0 0 0 0 3 0 0 0 0 3 0
0 0 0 0 0 0 0 0 0 0 0 0 0 0 0 0 0 0 0 3 2 0 2 0 0 0 2 2 0 2 0 2 0 0 0 2 0 0 2 2 3 2 0 5 0 3 2 0 0 0 2 2 2 2 0 2 2 0 2 0 0 0 0 2 0 2 2 2 2 2 2 4 2 4 0 5 2 2 2 2 0 0 0 0 0 0 0 0 0 0 0 0 0 0 0 0 0 0 0 3
0 0 0 0 0 4 0 0 0 0 0 0 0 0 0 0 0 0 0 0 0 0 2 2 2 0 0 0 2 2 0 0 0 0 2 0 0 2 0 2 0 0 0 2 0 0 0 0 0 2 0 2 2 2 2 3 2 2 0 0 2 0 2 0 0 0 0 2 2 0 2 2 0 0 0 2 0 0 0 0 0 0 0 0 3 0 0 0 0 0 0 0 0 0 0 0 0 0 0 7
0 0 0 0 0 0 0 0 0 0 0 0 8 8 8 8 8 8 8 8 8 8 8 8 8 0 2 5 2 5 2 0 2 0 2 2 2 2 2 0 0 2 0 0 0 0 5 0 0 2 2 2 0 0 2 0 2 2 2 5 2 0 0 2 0 0 2 0 0 2 2 0 0 0 2 0 0 2 2 5 0 0 0 0 0 0 0 0 0 0 0 0 0 0 0 0 0 0 0 0
0 0 0 0 0 0 0 0 0 0 0 0 8 8 8 8 8 8 8 8 8 2 5 0 0 0 2 0 0 0 0 2 0 5 2 0 2 2 2 0 0 2 0 2 2 0 2 2 0 7 2 2 2 0 0 2 0 2 2 2 0 2 0 2 0 2 2 2 2 0 2 2 2 2 0 2 2 2 2 0 0 0 0 0 3 0 3 0 0 0 0 0 0 0 0 0 0 0 0 0
0 0 0 0 0 0 0 0 0 3 0 6 8 8 8 8 8 0 0 6 0 6 6 6 0 0 6 6 0 6 0 0 6 6 0 0 6 0 6 6 6 6 6 0 4 6 0 6 6 0 6 0 0 6 0 0 6 0 6 6 6 6 0 6 6 6 0 0 6 6 6 6 6 6 6 0 0 6 0 6 0 6 6 0 6 6 6 6 6 0 0 0 0 0 0 0 0 0 0 0
0 0 0 0 0 0 0 0 0 0 0 0 8 8 8 8 8 8 0 0 0 0 4 0 0 0 0 0 0 0 0 0 0 0 0 0 0 0 0 0 0 0 0 0 0 0 0 0 0 0 0 0 0 0 0 4 0 0 0 0 0 0 7 0 0 0 0 0 0 0 0 0 0 0 0 0 0 0 0 0 0 7 0 0 0 0 0 0 0 0 0 0 0 0 0 0 0 3 0 0
0 0 0 0 0 0 0 0 0 0 0 0 8 8 8 8 8 8 8 8 8 8 8 8 8 8 0 0 0 0 0 0 0 0 0 0 0 4 0 0 0 3 0 0 0 0 0 0 0 0 0 0 0 0 0 0 0 0 0 0 0 0 0 0 0 0 0 0 0 0 0 0 0 0 0 0 0 0 0 0 0 0 0 0 0 0 0 0 0 0 0 0 0 0 0 0 0 0 0 0
0 0 0 0 0 0 0 0 0 0 0 0 8 8 8 8 8 8 8 8 8 8 8 8 8 0 0 0 0 0 0 4 0 0 0 7 0 0 0 0 0 0 0 0 0 0 0 0 0 0 0 0 0 0 0 0 0 0 0 0 0 0 7 0 0 0 0 0 0 0 0 0 0 0 0 0 0 0 0 0 0 0 0 0 0 0 0 0 0 0 0 0 0 0 0 0 0 0 0 0
3 0 0 0 0 0 0 0 0 0 0 0 8 8 8 8 8 8 8 0 0 0 0 0 0 0 0 0 0 0 0 0 0 0 3 0 0 0 0 0 0 0 0 0 3 0 0 7 0 0 0 0 0 0 0 0 0 0 0 0 0 0 0 0 0 0 0 0 0 0 0 0 0 0 0 0 7 0 4 0 0 0 0 0 3 0 0 0 0 0 0 0 4 0 0 0 0 0 0 0
0 0 0 0 0 0 0 0 0 0 0 0 0 0 0 0 0 0 0 0 0 0 0 0 0 0 0 0 0 0 0 0 0 0 0 0 0 0 0 0 0 0 0 0 0 0 0 0 0 0 0 0 0 0 0 0 0 0 0 0 0 0 0 0 0 0 0 0 0 0 0 0 0 0 0 0 0 0 0 0 0 0 0 0 0 0 0 0 0 0 3 0 0 0 0 0 0 0 0 0
0 0 0 0 0 0 0 0 0 0 0 0 0 3 0 0 0 0 0 0 0 0 0 0 0 0 0 0 0 0 0 0 0 0 0 0 0 0 0 0 0 0 0 0 0 0 0 0 0 0 0 0 0 0 0 0 0 0 0 0 0 0 0 0 0 0 0 0 0 0 4 0 0 0 0 0 0 0 0 0 0 0 0 0 0 0 0 0 0 0 0 0 0 0 0 0 0 0 3 0
0 0 0 0 0 0 0 0 0 0 4 0 0 0 0 0 0 0 0 0 0 0 0 0 0 0 0 0 0 0 0 0 0 0 0 0 0 0 0 0 0 0 0 0 0 0 0 0 0 0 0 0 0 0 0 0 0 0 0 0 0 0 0 0 0 0 0 0 0 0 0 0 0 0 0 0 0 0 0 0 0 0 0 0 0 0 0 0 0 0 3 0 0 0 0 0 0 0 0 0
0 0 0 0 0 0 0 0 0 0 0 0 0 0 0 0 0 0 0 0 0 0 0 0 0 0 0 0 0 0 0 0 0 0 0 0 0 0 0 0 0 0 0 0 0 0 0 0 0 0 0 0 0 0 0 0 0 0 0 0 0 0 0 0 0 0 0 0 0 0 0 0 0 0 0 0 0 0 0 0 0 0 0 0 0 0 0 7 0 0 0 0 0 0 0 0 0 4 0 0
0 0 0 0 0 0 0 3 0 0 0 0 0 0 0 0 0 0 0 0 0 0 0 0 0 0 0 0 0 0 0 0 0 0 0 0 0 0 0 0 0 0 0 0 0 0 0 0 0 0 3 0 0 0 0 0 0 0 0 0 0 0 0 0 0 0 0 0 0 0 0 0 0 0 0 0 0 0 0 0 0 0 0 0 0 0 0 0 0 0 0 7 0 0 0 0 0 0 0 0
0 0 0 0 0 0 0 0 0 0 0 0 0 0 0 0 0 0 0 0 0 0 0 0 0 0 0 3 0 0 0 0 0 0 0 0 0 0 0 0 0 0 0 0 0 0 0 0 0 0 0 0 0 0 0 0 0 0 0 0 0 0 0 3 0 0 0 0 0 0 0 0 0 0 0 0 0 0 0 0 0 0 0 0 0 0 0 0 0 0 0 0 0 0 0 0 0 0 0 0
0 0 0 0 0 0 0 0 0 0 0 0 0 0 0 0 0 0 0 0 4 0 0 0 0 0 0 0 0 4 0 0 0 0 0 3 0 0 0 0 0 0 0 0 0 0 0 0 0 0 0 0 0 0 0 0 0 0 0 0 0 3 0 0 0 0 0 0 0 0 0 0 0 0 3 0 0 0 0 0 0 0 0 0 0 7 0 0 0 0 0 0 0 0 0 0 0 0 0 0
0 0 0 0 0 0 0 0 0 0 0 0 0 0 0 0 0 0 0 0 0 0 0 0 0 0 0 0 0 0 4 0 0 0 0 0 0 0 0 0 0 0 0 0 0 0 0 0 0 4 0 0 0 0 0 0 0 0 0 0 0 0 0 0 0 0 0 0 0 0 0 0 0 0 0 0 0 0 0 0 0 0 0 0 0 0 0 0 0 0 0 0 0 0 0 0 0 0 7 0
0 0 3 0 0 0 0 0 0 0 0 0 0 0 0 0 0 0 0 0 0 0 0 0 0 0 0 0 0 0 4 0 0 0 0 0 0 0 0 0 0 0 0 0 4 0 3 0 0 0 0 0 0 0 0 0 0 0 0 0 0 0 0 0 0 0 0 0 0 0 0 0 0 0 0 0 0 0 0 0 0 0 0 0 0 0 0 0 0 0 0 0 0 0 0 0 0 0 0 0
0 0 0 0 0 0 0 0 0 0 0 0 0 0 0 0 0 0 0 0 0 0 3 0 0 0 0 0 0 0 0 0 0 0 0 0 3 0 0 0 0 0 0 0 0 0 0 0 0 0 0 0 0 0 0 0 0 0 0 0 0 0 0 0 0 0 0 0 0 0 0 0 0 0 0 0 0 0 0 0 0 0 0 0 0 0 0 0 0 0 0 0 0 0 0 0 0 0 0 0
0 0 0 0 0 0 0 0 0 0 0 0 0 0 0 0 0 0 0 0 0 0 0 0 0 0 0 0 0 0 0 0 0 3 0 0 0 0 0 0 0 0 0 0 0 7 0 0 0 0 0 0 0 0 0 0 0 0 0 0 0 0 0 0 0 0 0 0 0 0 0 0 0 0 0 0 0 0 0 0 0 0 0 0 0 0 0 0 0 0 0 0 0 0 0 0 0 0 0 0
3 0 0 0 0 0 0 0 0 0 0 0 0 0 0 0 0 0 0 0 0 0 0 0 0 0 0 0 0 0 0 0 0 0 0 0 0 0 0 0 0 0 0 0 0 0 0 0 0 0 0 0 0 0 0 0 0 3 0 0 0 0 0 0 0 0 0 0 0 0 0 0 0 0 0 0 0 0 0 0 0 0 0 0 0 0 0 0 0 0 0 0 0 0 0 0 0 0 0 0
0 0 0 0 0 0 0 0 0 0 0 0 0 0 0 0 0 0 0 0 0 0 0 0 0 0 0 0 0 0 0 0 0 0 0 0 0 0 0 0 0 0 0 0 0 0 0 0 0 0 0 0 0 0 0 0 0 0 0 0 0 0 0 0 7 0 0 0 0 0 0 0 0 0 0 0 0 3 0 0 0 7 0 0 0 0 0 0 0 0 0 0 0 0 0 0 0 0 0 0
0 0 0 0 0 0 0 3 0 0 0 0 0 4 0 0 0 0 0 0 0 0 0 0 0 0 0 0 0 0 0 0 4 0 0 0 0 0 0 0 0 0 0 0 0 0 3 0 0 0 0 0 0 0 0 0 0 0 0 0 0 0 0 0 0 0 0 0 0 0 0 0 0 0 0 0 0 0 0 0 0 0 0 0 0 0 0 0 0 0 0 0 0 0 0 0 0 0 0 0
0 0 0 0 0 0 0 0 0 0 0 0 0 0 0 0 3 0 0 0 0 0 0 0 0 0 0 0 0 0 0 0 3 0 0 0 0 0 0 0 0 0 0 0 0 0 0 3 0 0 0 0 0 0 0 0 0 0 0 0 0 0 0 0 0 0 0 0 0 0 0 0 0 0 0 0 0 0 0 0 0 0 0 0 0 0 0 0 0 0 0 0 0 0 0 0 0 0 0 0
